rundate,report_period,region_num,foreign_region,foreign_country,uk_group,uk_apt,foreign_apt,ty_t_pax,ty_s_pax,ty_c_pax,ly_t_pax,ly_s_pax,ly_c_pax,pc_change
20/03/2023 10:46,2022,1,WESTERN EUROPE-EU,AUSTRIA,1,GATWICK,INNSBRUCK,131247,109163,22084,9300,8230,1070,1311.25806
20/03/2023 10:46,2022,1,WESTERN EUROPE-EU,AUSTRIA,1,GATWICK,SALZBURG,48452,35061,13391,1858,1544,314,2507.75027
20/03/2023 10:46,2022,1,WESTERN EUROPE-EU,AUSTRIA,1,GATWICK,VIENNA,203487,203425,62,106,106,0,191868.86792
20/03/2023 10:46,2022,1,WESTERN EUROPE-EU,AUSTRIA,1,HEATHROW,INNSBRUCK,36025,36025,0,2541,2541,0,1317.74892
20/03/2023 10:46,2022,1,WESTERN EUROPE-EU,AUSTRIA,1,HEATHROW,SALZBURG,26813,26813,0,2419,2419,0,1008.43324
20/03/2023 10:46,2022,1,WESTERN EUROPE-EU,AUSTRIA,1,HEATHROW,VIENNA,589365,589365,0,135223,135223,0,335.84671
20/03/2023 10:46,2022,1,WESTERN EUROPE-EU,AUSTRIA,1,LONDON CITY,SALZBURG,2251,2251,0,0,0,0,0
20/03/2023 10:46,2022,1,WESTERN EUROPE-EU,AUSTRIA,1,LUTON,INNSBRUCK,8908,3624,5284,679,307,372,1211.92931
20/03/2023 10:46,2022,1,WESTERN EUROPE-EU,AUSTRIA,1,LUTON,SALZBURG,6220,6220,0,492,492,0,1164.22764
20/03/2023 10:46,2022,1,WESTERN EUROPE-EU,AUSTRIA,1,LUTON,VIENNA,11964,11841,123,19345,19345,0,-38.15456
20/03/2023 10:46,2022,1,WESTERN EUROPE-EU,AUSTRIA,1,STANSTED,INNSBRUCK,9197,4526,4671,563,295,268,1533.57016
20/03/2023 10:46,2022,1,WESTERN EUROPE-EU,AUSTRIA,1,STANSTED,KLAGENFURT,4640,4640,0,0,0,0,0
20/03/2023 10:46,2022,1,WESTERN EUROPE-EU,AUSTRIA,1,STANSTED,SALZBURG,79132,76580,2552,4867,4797,70,1525.88864
20/03/2023 10:46,2022,1,WESTERN EUROPE-EU,AUSTRIA,1,STANSTED,VIENNA,226120,226120,0,69573,68593,980,225.01114
20/03/2023 10:46,2022,1,WESTERN EUROPE-EU,AUSTRIA,2,BELFAST CITY (GEORGE BEST),SALZBURG,0,0,0,1,0,1,-100
20/03/2023 10:46,2022,1,WESTERN EUROPE-EU,AUSTRIA,2,BELFAST INTERNATIONAL,SALZBURG,3623,3163,460,41,41,0,8736.58537
20/03/2023 10:46,2022,1,WESTERN EUROPE-EU,AUSTRIA,2,BELFAST INTERNATIONAL,VIENNA,177,0,177,130,37,93,36.15385
20/03/2023 10:46,2022,1,WESTERN EUROPE-EU,AUSTRIA,2,BIGGIN HILL,INNSBRUCK,8,0,8,0,0,0,0
20/03/2023 10:46,2022,1,WESTERN EUROPE-EU,AUSTRIA,2,BIGGIN HILL,SALZBURG,2,0,2,12,0,12,-83.33333
20/03/2023 10:46,2022,1,WESTERN EUROPE-EU,AUSTRIA,2,BIGGIN HILL,VIENNA,10,0,10,1,0,1,900
20/03/2023 10:46,2022,1,WESTERN EUROPE-EU,AUSTRIA,2,BIRMINGHAM,GRAZ,0,0,0,101,0,101,-100
20/03/2023 10:46,2022,1,WESTERN EUROPE-EU,AUSTRIA,2,BIRMINGHAM,INNSBRUCK,20115,9627,10488,774,346,428,2498.83721
20/03/2023 10:46,2022,1,WESTERN EUROPE-EU,AUSTRIA,2,BIRMINGHAM,SALZBURG,12207,4633,7574,442,231,211,2661.76471
20/03/2023 10:46,2022,1,WESTERN EUROPE-EU,AUSTRIA,2,BIRMINGHAM,VIENNA,2867,2867,0,0,0,0,0
20/03/2023 10:46,2022,1,WESTERN EUROPE-EU,AUSTRIA,2,BOURNEMOUTH,KLAGENFURT,112,0,112,0,0,0,0
20/03/2023 10:46,2022,1,WESTERN EUROPE-EU,AUSTRIA,2,BRISTOL,INNSBRUCK,20602,16369,4233,1178,947,231,1648.89643
20/03/2023 10:46,2022,1,WESTERN EUROPE-EU,AUSTRIA,2,BRISTOL,SALZBURG,11342,8633,2709,422,355,67,2587.67773
20/03/2023 10:46,2022,1,WESTERN EUROPE-EU,AUSTRIA,2,BRISTOL,VIENNA,28054,28054,0,2212,2212,0,1168.26401
20/03/2023 10:46,2022,1,WESTERN EUROPE-EU,AUSTRIA,2,CARDIFF WALES,VIENNA,735,0,735,54,0,54,1261.11111
20/03/2023 10:46,2022,1,WESTERN EUROPE-EU,AUSTRIA,2,EAST MIDLANDS INTERNATIONAL,SALZBURG,5388,3359,2029,133,38,95,3951.12782
20/03/2023 10:46,2022,1,WESTERN EUROPE-EU,AUSTRIA,2,EDINBURGH,INNSBRUCK,9348,4223,5125,271,149,122,3349.44649
20/03/2023 10:46,2022,1,WESTERN EUROPE-EU,AUSTRIA,2,EDINBURGH,KLAGENFURT,0,0,0,82,82,0,-100
20/03/2023 10:46,2022,1,WESTERN EUROPE-EU,AUSTRIA,2,EDINBURGH,SALZBURG,4174,4174,0,173,173,0,2312.71676
20/03/2023 10:46,2022,1,WESTERN EUROPE-EU,AUSTRIA,2,EDINBURGH,VIENNA,45163,45163,0,7192,7145,47,527.96162
20/03/2023 10:46,2022,1,WESTERN EUROPE-EU,AUSTRIA,2,GLASGOW,SALZBURG,4900,0,4900,0,0,0,0
20/03/2023 10:46,2022,1,WESTERN EUROPE-EU,AUSTRIA,2,GLASGOW,VIENNA,142,0,142,148,0,148,-4.05405
20/03/2023 10:46,2022,1,WESTERN EUROPE-EU,AUSTRIA,2,LEEDS BRADFORD,SALZBURG,4739,4739,0,143,143,0,3213.98601
20/03/2023 10:46,2022,1,WESTERN EUROPE-EU,AUSTRIA,2,LEEDS BRADFORD,VIENNA,2110,1703,407,0,0,0,0
20/03/2023 10:46,2022,1,WESTERN EUROPE-EU,AUSTRIA,2,LIVERPOOL (JOHN LENNON),SALZBURG,3915,3829,86,211,162,49,1755.45024
20/03/2023 10:46,2022,1,WESTERN EUROPE-EU,AUSTRIA,2,LIVERPOOL (JOHN LENNON),VIENNA,26051,25961,90,1503,1503,0,1633.2668
20/03/2023 10:46,2022,1,WESTERN EUROPE-EU,AUSTRIA,2,MANCHESTER,INNSBRUCK,37722,27044,10678,1355,880,475,2683.91144
20/03/2023 10:46,2022,1,WESTERN EUROPE-EU,AUSTRIA,2,MANCHESTER,KLAGENFURT,384,384,0,0,0,0,0
20/03/2023 10:46,2022,1,WESTERN EUROPE-EU,AUSTRIA,2,MANCHESTER,SALZBURG,20866,10308,10558,853,582,271,2346.18992
20/03/2023 10:46,2022,1,WESTERN EUROPE-EU,AUSTRIA,2,MANCHESTER,VIENNA,74938,74938,0,12596,12596,0,494.9349
20/03/2023 10:46,2022,1,WESTERN EUROPE-EU,AUSTRIA,2,NEWCASTLE,INNSBRUCK,3820,3820,0,130,130,0,2838.46154
20/03/2023 10:46,2022,1,WESTERN EUROPE-EU,AUSTRIA,2,NEWCASTLE,SALZBURG,5381,5257,124,0,0,0,0
20/03/2023 10:46,2022,1,WESTERN EUROPE-EU,AUSTRIA,2,NEWCASTLE,VIENNA,2296,2296,0,0,0,0,0
20/03/2023 10:46,2022,1,WESTERN EUROPE-EU,AUSTRIA,2,NORWICH,SALZBURG,57,0,57,0,0,0,0
20/03/2023 10:46,2022,1,WESTERN EUROPE-EU,AUSTRIA,2,OXFORD (KIDLINGTON),GRAZ,0,0,0,50,50,0,-100
20/03/2023 10:46,2022,1,WESTERN EUROPE-EU,AUSTRIA,2,SOUTHAMPTON,SALZBURG,1301,1301,0,0,0,0,0
20/03/2023 10:46,2022,1,WESTERN EUROPE-EU,AUSTRIA,2,TEESSIDE INTERNATIONAL AIRPORT,GRAZ,0,0,0,54,0,54,-100
20/03/2023 10:46,2022,1,WESTERN EUROPE-EU,AUSTRIA,2,TEESSIDE INTERNATIONAL AIRPORT,VIENNA,0,0,0,56,0,56,-100
20/03/2023 10:46,2022,1,WESTERN EUROPE-EU,BELGIUM,1,HEATHROW,BRUSSELS,431729,431729,0,118397,118397,0,264.64522
20/03/2023 10:46,2022,1,WESTERN EUROPE-EU,BELGIUM,1,LUTON,LIEGE,0,0,0,309,0,309,-100
20/03/2023 10:46,2022,1,WESTERN EUROPE-EU,BELGIUM,1,LUTON,OSTEND,130,130,0,0,0,0,0
20/03/2023 10:46,2022,1,WESTERN EUROPE-EU,BELGIUM,1,STANSTED,BRUSSELS,247,247,0,161,161,0,53.41615
20/03/2023 10:46,2022,1,WESTERN EUROPE-EU,BELGIUM,1,STANSTED,CHARLEROI,0,0,0,52,0,52,-100
20/03/2023 10:46,2022,1,WESTERN EUROPE-EU,BELGIUM,2,BELFAST INTERNATIONAL,CHARLEROI,3,0,3,0,0,0,0
20/03/2023 10:46,2022,1,WESTERN EUROPE-EU,BELGIUM,2,BIGGIN HILL,ANTWERP,0,0,0,67,0,67,-100
20/03/2023 10:46,2022,1,WESTERN EUROPE-EU,BELGIUM,2,BIGGIN HILL,BRUSSELS,6,0,6,0,0,0,0
20/03/2023 10:46,2022,1,WESTERN EUROPE-EU,BELGIUM,2,BIRMINGHAM,BRUSSELS,51851,51851,0,4163,4075,88,1145.52006
20/03/2023 10:46,2022,1,WESTERN EUROPE-EU,BELGIUM,2,BIRMINGHAM,CHARLEROI,202,202,0,0,0,0,0
20/03/2023 10:46,2022,1,WESTERN EUROPE-EU,BELGIUM,2,BIRMINGHAM,LIEGE,0,0,0,63,0,63,-100
20/03/2023 10:46,2022,1,WESTERN EUROPE-EU,BELGIUM,2,CARDIFF WALES,BRUSSELS,400,0,400,426,0,426,-6.10329
20/03/2023 10:46,2022,1,WESTERN EUROPE-EU,BELGIUM,2,CITY OF DERRY (EGLINTON),LIEGE,74,0,74,0,0,0,0
20/03/2023 10:46,2022,1,WESTERN EUROPE-EU,BELGIUM,2,DONCASTER SHEFFIELD,CHARLEROI,142,0,142,0,0,0,0
20/03/2023 10:46,2022,1,WESTERN EUROPE-EU,BELGIUM,2,EDINBURGH,BRUSSELS,51887,51368,519,5433,5355,78,855.03405
20/03/2023 10:46,2022,1,WESTERN EUROPE-EU,BELGIUM,2,EDINBURGH,CHARLEROI,105767,105767,0,14913,14913,0,609.22685
20/03/2023 10:46,2022,1,WESTERN EUROPE-EU,BELGIUM,2,GLASGOW,ANTWERP,0,0,0,47,0,47,-100
20/03/2023 10:46,2022,1,WESTERN EUROPE-EU,BELGIUM,2,GLASGOW,BRUSSELS,280,0,280,142,0,142,97.1831
20/03/2023 10:46,2022,1,WESTERN EUROPE-EU,BELGIUM,2,GLASGOW,CHARLEROI,19520,19520,0,0,0,0,0
20/03/2023 10:46,2022,1,WESTERN EUROPE-EU,BELGIUM,2,HUMBERSIDE,OSTEND,0,0,0,93,0,93,-100
20/03/2023 10:46,2022,1,WESTERN EUROPE-EU,BELGIUM,2,LIVERPOOL (JOHN LENNON),BRUSSELS,86,0,86,0,0,0,0
20/03/2023 10:46,2022,1,WESTERN EUROPE-EU,BELGIUM,2,LIVERPOOL (JOHN LENNON),CHARLEROI,17870,17870,0,0,0,0,0
20/03/2023 10:46,2022,1,WESTERN EUROPE-EU,BELGIUM,2,LIVERPOOL (JOHN LENNON),LIEGE,86,0,86,0,0,0,0
20/03/2023 10:46,2022,1,WESTERN EUROPE-EU,BELGIUM,2,LIVERPOOL (JOHN LENNON),OSTEND,0,0,0,40,0,40,-100
20/03/2023 10:46,2022,1,WESTERN EUROPE-EU,BELGIUM,2,MANCHESTER,BRUSSELS,128311,128219,92,40255,40255,0,218.7455
20/03/2023 10:46,2022,1,WESTERN EUROPE-EU,BELGIUM,2,MANCHESTER,CHARLEROI,179302,179302,0,25482,25482,0,603.64179
20/03/2023 10:46,2022,1,WESTERN EUROPE-EU,BELGIUM,2,MANCHESTER,OSTEND,0,0,0,1257,0,1257,-100
20/03/2023 10:46,2022,1,WESTERN EUROPE-EU,BELGIUM,2,OXFORD (KIDLINGTON),LIEGE,0,0,0,49,49,0,-100
20/03/2023 10:46,2022,1,WESTERN EUROPE-EU,BELGIUM,2,PRESTWICK,CHARLEROI,47,47,0,0,0,0,0
20/03/2023 10:46,2022,1,WESTERN EUROPE-EU,CROATIA,1,GATWICK,DUBROVNIK,196255,193525,2730,26476,26476,0,641.25623
20/03/2023 10:46,2022,1,WESTERN EUROPE-EU,CROATIA,1,GATWICK,PULA,42126,28295,13831,10297,5344,4953,309.10945
20/03/2023 10:46,2022,1,WESTERN EUROPE-EU,CROATIA,1,GATWICK,RIJEKA,1308,1234,74,0,0,0,0
20/03/2023 10:46,2022,1,WESTERN EUROPE-EU,CROATIA,1,GATWICK,SPLIT,158855,143047,15808,38424,35227,3197,313.4265
20/03/2023 10:46,2022,1,WESTERN EUROPE-EU,CROATIA,1,GATWICK,ZADAR,13698,13575,123,4831,2304,2527,183.54378
20/03/2023 10:46,2022,1,WESTERN EUROPE-EU,CROATIA,1,GATWICK,ZAGREB,133,133,0,0,0,0,0
20/03/2023 10:46,2022,1,WESTERN EUROPE-EU,CROATIA,1,HEATHROW,DUBROVNIK,37187,37187,0,48453,48453,0,-23.2514
20/03/2023 10:46,2022,1,WESTERN EUROPE-EU,CROATIA,1,HEATHROW,PULA,8747,8747,0,3781,3781,0,131.34092
20/03/2023 10:46,2022,1,WESTERN EUROPE-EU,CROATIA,1,HEATHROW,SPLIT,59830,59830,0,35733,35733,0,67.43626
20/03/2023 10:46,2022,1,WESTERN EUROPE-EU,CROATIA,1,HEATHROW,ZAGREB,108463,108186,277,40000,39968,32,171.1575
20/03/2023 10:46,2022,1,WESTERN EUROPE-EU,CROATIA,1,LONDON CITY,SPLIT,5007,5007,0,3234,3234,0,54.82375
20/03/2023 10:46,2022,1,WESTERN EUROPE-EU,CROATIA,1,LUTON,DUBROVNIK,20307,20124,183,0,0,0,0
20/03/2023 10:46,2022,1,WESTERN EUROPE-EU,CROATIA,1,LUTON,PULA,10598,10598,0,1100,966,134,863.45455
20/03/2023 10:46,2022,1,WESTERN EUROPE-EU,CROATIA,1,LUTON,SPLIT,92327,92327,0,30123,30123,0,206.50002
20/03/2023 10:46,2022,1,WESTERN EUROPE-EU,CROATIA,1,LUTON,ZAGREB,209,209,0,0,0,0,0
20/03/2023 10:46,2022,1,WESTERN EUROPE-EU,CROATIA,1,STANSTED,DUBROVNIK,36206,36206,0,12782,12782,0,183.25771
20/03/2023 10:46,2022,1,WESTERN EUROPE-EU,CROATIA,1,STANSTED,PULA,23500,23500,0,14368,14337,31,63.55791
20/03/2023 10:46,2022,1,WESTERN EUROPE-EU,CROATIA,1,STANSTED,RIJEKA,15883,15883,0,0,0,0,0
20/03/2023 10:46,2022,1,WESTERN EUROPE-EU,CROATIA,1,STANSTED,SPLIT,15050,15050,0,7280,7280,0,106.73077
20/03/2023 10:46,2022,1,WESTERN EUROPE-EU,CROATIA,1,STANSTED,ZADAR,42883,42883,0,18060,18060,0,137.4474
20/03/2023 10:46,2022,1,WESTERN EUROPE-EU,CROATIA,1,STANSTED,ZAGREB,100537,100537,0,30330,29964,366,231.47709
20/03/2023 10:46,2022,1,WESTERN EUROPE-EU,CROATIA,2,BELFAST INTERNATIONAL,DUBROVNIK,8124,8124,0,0,0,0,0
20/03/2023 10:46,2022,1,WESTERN EUROPE-EU,CROATIA,2,BELFAST INTERNATIONAL,SPLIT,0,0,0,4586,4586,0,-100
20/03/2023 10:46,2022,1,WESTERN EUROPE-EU,CROATIA,2,BIGGIN HILL,DUBROVNIK,9,0,9,0,0,0,0
20/03/2023 10:46,2022,1,WESTERN EUROPE-EU,CROATIA,2,BIGGIN HILL,OSIJEK,0,0,0,3,0,3,-100
20/03/2023 10:46,2022,1,WESTERN EUROPE-EU,CROATIA,2,BIGGIN HILL,ZADAR,1,0,1,2,0,2,-50
20/03/2023 10:46,2022,1,WESTERN EUROPE-EU,CROATIA,2,BIRMINGHAM,DUBROVNIK,45555,45413,142,4003,4003,0,1038.02148
20/03/2023 10:46,2022,1,WESTERN EUROPE-EU,CROATIA,2,BIRMINGHAM,PULA,12266,0,12266,0,0,0,0
20/03/2023 10:46,2022,1,WESTERN EUROPE-EU,CROATIA,2,BIRMINGHAM,SPLIT,15704,15704,0,6369,6369,0,146.56932
20/03/2023 10:46,2022,1,WESTERN EUROPE-EU,CROATIA,2,BIRMINGHAM,ZADAR,12581,12581,0,0,0,0,0
20/03/2023 10:46,2022,1,WESTERN EUROPE-EU,CROATIA,2,BOURNEMOUTH,ZADAR,8996,8996,0,0,0,0,0
20/03/2023 10:46,2022,1,WESTERN EUROPE-EU,CROATIA,2,BRISTOL,DUBROVNIK,43185,43185,0,6497,6497,0,564.6914
20/03/2023 10:46,2022,1,WESTERN EUROPE-EU,CROATIA,2,BRISTOL,PULA,10104,10104,0,4271,4271,0,136.57223
20/03/2023 10:46,2022,1,WESTERN EUROPE-EU,CROATIA,2,BRISTOL,SPLIT,47353,47353,0,14928,14928,0,217.20927
20/03/2023 10:46,2022,1,WESTERN EUROPE-EU,CROATIA,2,CARDIFF WALES,DUBROVNIK,8601,0,8601,0,0,0,0
20/03/2023 10:46,2022,1,WESTERN EUROPE-EU,CROATIA,2,DONCASTER SHEFFIELD,DUBROVNIK,8088,7094,994,0,0,0,0
20/03/2023 10:46,2022,1,WESTERN EUROPE-EU,CROATIA,2,DONCASTER SHEFFIELD,PULA,7340,0,7340,0,0,0,0
20/03/2023 10:46,2022,1,WESTERN EUROPE-EU,CROATIA,2,EAST MIDLANDS INTERNATIONAL,DUBROVNIK,16599,12752,3847,0,0,0,0
20/03/2023 10:46,2022,1,WESTERN EUROPE-EU,CROATIA,2,EDINBURGH,DUBROVNIK,38175,38175,0,8307,8307,0,359.55218
20/03/2023 10:46,2022,1,WESTERN EUROPE-EU,CROATIA,2,EDINBURGH,RIJEKA,0,0,0,214,0,214,-100
20/03/2023 10:46,2022,1,WESTERN EUROPE-EU,CROATIA,2,EDINBURGH,SPLIT,6708,6708,0,0,0,0,0
20/03/2023 10:46,2022,1,WESTERN EUROPE-EU,CROATIA,2,EDINBURGH,ZADAR,19264,19264,0,3051,3051,0,531.39954
20/03/2023 10:46,2022,1,WESTERN EUROPE-EU,CROATIA,2,GLASGOW,DUBROVNIK,8502,6677,1825,0,0,0,0
20/03/2023 10:46,2022,1,WESTERN EUROPE-EU,CROATIA,2,GLASGOW,PULA,5391,5391,0,56,0,56,9526.78571
20/03/2023 10:46,2022,1,WESTERN EUROPE-EU,CROATIA,2,GLASGOW,SPLIT,18368,18368,0,4236,4236,0,333.61662
20/03/2023 10:46,2022,1,WESTERN EUROPE-EU,CROATIA,2,LEEDS BRADFORD,DUBROVNIK,16358,16358,0,6528,6528,0,150.58211
20/03/2023 10:46,2022,1,WESTERN EUROPE-EU,CROATIA,2,LEEDS BRADFORD,SPLIT,11946,11946,0,2760,2760,0,332.82609
20/03/2023 10:46,2022,1,WESTERN EUROPE-EU,CROATIA,2,LEEDS BRADFORD,ZADAR,14964,14964,0,0,0,0,0
20/03/2023 10:46,2022,1,WESTERN EUROPE-EU,CROATIA,2,LIVERPOOL (JOHN LENNON),OSIJEK,110,0,110,0,0,0,0
20/03/2023 10:46,2022,1,WESTERN EUROPE-EU,CROATIA,2,LIVERPOOL (JOHN LENNON),ZADAR,9398,9398,0,0,0,0,0
20/03/2023 10:46,2022,1,WESTERN EUROPE-EU,CROATIA,2,MANCHESTER,DUBROVNIK,85195,82326,2869,21294,21294,0,300.08923
20/03/2023 10:46,2022,1,WESTERN EUROPE-EU,CROATIA,2,MANCHESTER,PULA,13317,0,13317,4580,0,4580,190.76419
20/03/2023 10:46,2022,1,WESTERN EUROPE-EU,CROATIA,2,MANCHESTER,SPLIT,73750,59932,13818,28412,22717,5695,159.57342
20/03/2023 10:46,2022,1,WESTERN EUROPE-EU,CROATIA,2,MANCHESTER,ZADAR,10341,9627,714,7103,7103,0,45.58637
20/03/2023 10:46,2022,1,WESTERN EUROPE-EU,CROATIA,2,MANCHESTER,ZAGREB,27968,27968,0,1454,1454,0,1823.52132
20/03/2023 10:46,2022,1,WESTERN EUROPE-EU,CROATIA,2,NEWCASTLE,DUBROVNIK,17643,17643,0,3280,3280,0,437.89634
20/03/2023 10:46,2022,1,WESTERN EUROPE-EU,CROATIA,2,NEWCASTLE,ZADAR,16706,16706,0,0,0,0,0
20/03/2023 10:46,2022,1,WESTERN EUROPE-EU,CYPRUS,1,GATWICK,LARNACA,322303,275267,47036,50461,39016,11445,538.71703
20/03/2023 10:46,2022,1,WESTERN EUROPE-EU,CYPRUS,1,GATWICK,PAPHOS,358312,284234,74078,77575,55143,22432,361.89107
20/03/2023 10:46,2022,1,WESTERN EUROPE-EU,CYPRUS,1,HEATHROW,LARNACA,313479,313479,0,181107,181002,105,73.09049
20/03/2023 10:46,2022,1,WESTERN EUROPE-EU,CYPRUS,1,HEATHROW,PAPHOS,15987,15987,0,32767,32767,0,-51.21006
20/03/2023 10:46,2022,1,WESTERN EUROPE-EU,CYPRUS,1,LUTON,LARNACA,115891,115891,0,41985,41985,0,176.02953
20/03/2023 10:46,2022,1,WESTERN EUROPE-EU,CYPRUS,1,LUTON,PAPHOS,50349,50179,170,20544,20544,0,145.07886
20/03/2023 10:46,2022,1,WESTERN EUROPE-EU,CYPRUS,1,STANSTED,LARNACA,51997,51997,0,23531,19397,4134,120.97233
20/03/2023 10:46,2022,1,WESTERN EUROPE-EU,CYPRUS,1,STANSTED,PAPHOS,210261,188198,22063,87947,78958,8989,139.07694
20/03/2023 10:46,2022,1,WESTERN EUROPE-EU,CYPRUS,2,ABERDEEN,LARNACA,0,0,0,123,0,123,-100
20/03/2023 10:46,2022,1,WESTERN EUROPE-EU,CYPRUS,2,BELFAST CITY (GEORGE BEST),LARNACA,59,0,59,0,0,0,0
20/03/2023 10:46,2022,1,WESTERN EUROPE-EU,CYPRUS,2,BELFAST INTERNATIONAL,PAPHOS,11188,11188,0,0,0,0,0
20/03/2023 10:46,2022,1,WESTERN EUROPE-EU,CYPRUS,2,BIGGIN HILL,LARNACA,65,0,65,20,0,20,225
20/03/2023 10:46,2022,1,WESTERN EUROPE-EU,CYPRUS,2,BIGGIN HILL,PAPHOS,12,0,12,10,0,10,20
20/03/2023 10:46,2022,1,WESTERN EUROPE-EU,CYPRUS,2,BIRMINGHAM,LARNACA,100721,57037,43684,31699,18244,13455,217.74188
20/03/2023 10:46,2022,1,WESTERN EUROPE-EU,CYPRUS,2,BIRMINGHAM,PAPHOS,106871,57915,48956,30934,14518,16416,245.4807
20/03/2023 10:46,2022,1,WESTERN EUROPE-EU,CYPRUS,2,BOURNEMOUTH,PAPHOS,11679,0,11679,9053,6678,2375,29.00696
20/03/2023 10:46,2022,1,WESTERN EUROPE-EU,CYPRUS,2,BRISTOL,LARNACA,78463,44401,34062,18373,12173,6200,327.05601
20/03/2023 10:46,2022,1,WESTERN EUROPE-EU,CYPRUS,2,BRISTOL,PAPHOS,98580,66521,32059,24094,14896,9198,309.14751
20/03/2023 10:46,2022,1,WESTERN EUROPE-EU,CYPRUS,2,CARDIFF WALES,LARNACA,22528,12931,9597,2785,0,2785,708.90485
20/03/2023 10:46,2022,1,WESTERN EUROPE-EU,CYPRUS,2,CARDIFF WALES,PAPHOS,19833,0,19833,0,0,0,0
20/03/2023 10:46,2022,1,WESTERN EUROPE-EU,CYPRUS,2,DONCASTER SHEFFIELD,LARNACA,11410,8435,2975,4799,4799,0,137.75787
20/03/2023 10:46,2022,1,WESTERN EUROPE-EU,CYPRUS,2,DONCASTER SHEFFIELD,PAPHOS,26756,0,26756,6075,0,6075,340.42798
20/03/2023 10:46,2022,1,WESTERN EUROPE-EU,CYPRUS,2,EAST MIDLANDS INTERNATIONAL,LARNACA,39010,20442,18568,11611,7793,3818,235.97451
20/03/2023 10:46,2022,1,WESTERN EUROPE-EU,CYPRUS,2,EAST MIDLANDS INTERNATIONAL,PAPHOS,51534,25340,26194,13590,6161,7429,279.2053
20/03/2023 10:46,2022,1,WESTERN EUROPE-EU,CYPRUS,2,EDINBURGH,LARNACA,10492,10492,0,2666,2588,78,293.54839
20/03/2023 10:46,2022,1,WESTERN EUROPE-EU,CYPRUS,2,EDINBURGH,PAPHOS,54756,54756,0,14605,14605,0,274.9127
20/03/2023 10:46,2022,1,WESTERN EUROPE-EU,CYPRUS,2,EXETER,PAPHOS,12085,0,12085,3265,0,3265,270.13783
20/03/2023 10:46,2022,1,WESTERN EUROPE-EU,CYPRUS,2,GLASGOW,LARNACA,10730,10730,0,5184,3000,2184,106.98302
20/03/2023 10:46,2022,1,WESTERN EUROPE-EU,CYPRUS,2,GLASGOW,PAPHOS,44755,24409,20346,8108,5808,2300,451.98569
20/03/2023 10:46,2022,1,WESTERN EUROPE-EU,CYPRUS,2,GUERNSEY,PAPHOS,0,0,0,9,0,9,-100
20/03/2023 10:46,2022,1,WESTERN EUROPE-EU,CYPRUS,2,LEEDS BRADFORD,LARNACA,39266,39266,0,14292,14292,0,174.74111
20/03/2023 10:46,2022,1,WESTERN EUROPE-EU,CYPRUS,2,LEEDS BRADFORD,PAPHOS,42920,42920,0,4590,4590,0,835.07625
20/03/2023 10:46,2022,1,WESTERN EUROPE-EU,CYPRUS,2,LIVERPOOL (JOHN LENNON),AKROTIRI,566,0,566,0,0,0,0
20/03/2023 10:46,2022,1,WESTERN EUROPE-EU,CYPRUS,2,LIVERPOOL (JOHN LENNON),LARNACA,23200,23200,0,6111,6111,0,279.64327
20/03/2023 10:46,2022,1,WESTERN EUROPE-EU,CYPRUS,2,LIVERPOOL (JOHN LENNON),PAPHOS,0,0,0,7510,7510,0,-100
20/03/2023 10:46,2022,1,WESTERN EUROPE-EU,CYPRUS,2,MANCHESTER,LARNACA,122927,70262,52665,41256,22189,19067,197.96151
20/03/2023 10:46,2022,1,WESTERN EUROPE-EU,CYPRUS,2,MANCHESTER,PAPHOS,292362,220874,71488,88277,59111,29166,231.18706
20/03/2023 10:46,2022,1,WESTERN EUROPE-EU,CYPRUS,2,NEWCASTLE,LARNACA,41709,41700,9,14027,14027,0,197.34797
20/03/2023 10:46,2022,1,WESTERN EUROPE-EU,CYPRUS,2,NEWCASTLE,PAPHOS,71649,71649,0,14881,14881,0,381.47974
20/03/2023 10:46,2022,1,WESTERN EUROPE-EU,CYPRUS,2,NORWICH,PAPHOS,7374,0,7374,0,0,0,0
20/03/2023 10:46,2022,1,WESTERN EUROPE-EU,DENMARK,1,GATWICK,COPENHAGEN,511928,511928,0,51967,51967,0,885.10208
20/03/2023 10:46,2022,1,WESTERN EUROPE-EU,DENMARK,1,GATWICK,ROSKILDE,0,0,0,119,0,119,-100
20/03/2023 10:46,2022,1,WESTERN EUROPE-EU,DENMARK,1,HEATHROW,BILLUND,57054,57054,0,0,0,0,0
20/03/2023 10:46,2022,1,WESTERN EUROPE-EU,DENMARK,1,HEATHROW,COPENHAGEN,659919,659748,171,215517,215517,0,206.20276
20/03/2023 10:46,2022,1,WESTERN EUROPE-EU,DENMARK,1,LONDON CITY,BILLUND,2208,2208,0,0,0,0,0
20/03/2023 10:46,2022,1,WESTERN EUROPE-EU,DENMARK,1,LUTON,COPENHAGEN,168,0,168,354,0,354,-52.54237
20/03/2023 10:46,2022,1,WESTERN EUROPE-EU,DENMARK,1,STANSTED,AALBORG,37621,37621,0,8026,8026,0,368.7391
20/03/2023 10:46,2022,1,WESTERN EUROPE-EU,DENMARK,1,STANSTED,AARHUS (TIRSTRUP),84316,84316,0,16316,16316,0,416.76882
20/03/2023 10:46,2022,1,WESTERN EUROPE-EU,DENMARK,1,STANSTED,BILLUND,201706,201706,0,47023,47023,0,328.95179
20/03/2023 10:46,2022,1,WESTERN EUROPE-EU,DENMARK,1,STANSTED,COPENHAGEN,318573,318286,287,79524,79484,40,300.59982
20/03/2023 10:46,2022,1,WESTERN EUROPE-EU,DENMARK,2,ABERDEEN,BILLUND,179,52,127,704,41,663,-74.57386
20/03/2023 10:46,2022,1,WESTERN EUROPE-EU,DENMARK,2,ABERDEEN,COPENHAGEN,1423,1423,0,1121,1121,0,26.94023
20/03/2023 10:46,2022,1,WESTERN EUROPE-EU,DENMARK,2,ABERDEEN,ESBJERG,11536,11536,0,2103,2024,79,448.54969
20/03/2023 10:46,2022,1,WESTERN EUROPE-EU,DENMARK,2,BELFAST CITY (GEORGE BEST),AALBORG,763,0,763,0,0,0,0
20/03/2023 10:46,2022,1,WESTERN EUROPE-EU,DENMARK,2,BELFAST INTERNATIONAL,AARHUS (TIRSTRUP),0,0,0,69,0,69,-100
20/03/2023 10:46,2022,1,WESTERN EUROPE-EU,DENMARK,2,BELFAST INTERNATIONAL,BILLUND,0,0,0,1,0,1,-100
20/03/2023 10:46,2022,1,WESTERN EUROPE-EU,DENMARK,2,BELFAST INTERNATIONAL,COPENHAGEN,0,0,0,33,0,33,-100
20/03/2023 10:46,2022,1,WESTERN EUROPE-EU,DENMARK,2,BIGGIN HILL,AARHUS (TIRSTRUP),0,0,0,10,0,10,-100
20/03/2023 10:46,2022,1,WESTERN EUROPE-EU,DENMARK,2,BIGGIN HILL,BILLUND,30,0,30,0,0,0,0
20/03/2023 10:46,2022,1,WESTERN EUROPE-EU,DENMARK,2,BIGGIN HILL,COPENHAGEN,0,0,0,9,0,9,-100
20/03/2023 10:46,2022,1,WESTERN EUROPE-EU,DENMARK,2,BIRMINGHAM,AALBORG,73,0,73,0,0,0,0
20/03/2023 10:46,2022,1,WESTERN EUROPE-EU,DENMARK,2,BIRMINGHAM,BILLUND,3764,3764,0,0,0,0,0
20/03/2023 10:46,2022,1,WESTERN EUROPE-EU,DENMARK,2,BIRMINGHAM,COPENHAGEN,17729,17597,132,131,28,103,13433.58779
20/03/2023 10:46,2022,1,WESTERN EUROPE-EU,DENMARK,2,BRISTOL,COPENHAGEN,26462,26462,0,0,0,0,0
20/03/2023 10:46,2022,1,WESTERN EUROPE-EU,DENMARK,2,CAMPBELTOWN,BILLUND,19,0,19,0,0,0,0
20/03/2023 10:46,2022,1,WESTERN EUROPE-EU,DENMARK,2,CARDIFF WALES,COPENHAGEN,0,0,0,27,0,27,-100
20/03/2023 10:46,2022,1,WESTERN EUROPE-EU,DENMARK,2,DONCASTER SHEFFIELD,COPENHAGEN,21,0,21,0,0,0,0
20/03/2023 10:46,2022,1,WESTERN EUROPE-EU,DENMARK,2,EAST MIDLANDS INTERNATIONAL,COPENHAGEN,0,0,0,200,200,0,-100
20/03/2023 10:46,2022,1,WESTERN EUROPE-EU,DENMARK,2,EDINBURGH,AALBORG,819,0,819,0,0,0,0
20/03/2023 10:46,2022,1,WESTERN EUROPE-EU,DENMARK,2,EDINBURGH,BILLUND,36948,36948,0,2265,1975,290,1531.25828
20/03/2023 10:46,2022,1,WESTERN EUROPE-EU,DENMARK,2,EDINBURGH,COPENHAGEN,180360,180246,114,29850,29419,431,504.22111
20/03/2023 10:46,2022,1,WESTERN EUROPE-EU,DENMARK,2,EDINBURGH,ROSKILDE,273,0,273,0,0,0,0
20/03/2023 10:46,2022,1,WESTERN EUROPE-EU,DENMARK,2,EDINBURGH,SONDERBORG,454,0,454,0,0,0,0
20/03/2023 10:46,2022,1,WESTERN EUROPE-EU,DENMARK,2,GLASGOW,BILLUND,0,0,0,86,0,86,-100
20/03/2023 10:46,2022,1,WESTERN EUROPE-EU,DENMARK,2,GLASGOW,COPENHAGEN,0,0,0,4167,0,4167,-100
20/03/2023 10:46,2022,1,WESTERN EUROPE-EU,DENMARK,2,GLASGOW,KARUP,0,0,0,92,0,92,-100
20/03/2023 10:46,2022,1,WESTERN EUROPE-EU,DENMARK,2,GLASGOW,ROSKILDE,0,0,0,51,0,51,-100
20/03/2023 10:46,2022,1,WESTERN EUROPE-EU,DENMARK,2,GUERNSEY,AALBORG,28,28,0,0,0,0,0
20/03/2023 10:46,2022,1,WESTERN EUROPE-EU,DENMARK,2,GUERNSEY,COPENHAGEN,109,109,0,116,116,0,-6.03448
20/03/2023 10:46,2022,1,WESTERN EUROPE-EU,DENMARK,2,GUERNSEY,SONDERBORG,227,227,0,0,0,0,0
20/03/2023 10:46,2022,1,WESTERN EUROPE-EU,DENMARK,2,HUMBERSIDE,BILLUND,0,0,0,906,0,906,-100
20/03/2023 10:46,2022,1,WESTERN EUROPE-EU,DENMARK,2,HUMBERSIDE,ESBJERG,142,142,0,0,0,0,0
20/03/2023 10:46,2022,1,WESTERN EUROPE-EU,DENMARK,2,INVERNESS,ROSKILDE,22,0,22,0,0,0,0
20/03/2023 10:46,2022,1,WESTERN EUROPE-EU,DENMARK,2,ISLE OF MAN,COPENHAGEN,51,0,51,0,0,0,0
20/03/2023 10:46,2022,1,WESTERN EUROPE-EU,DENMARK,2,ISLE OF MAN,SONDERBORG,422,0,422,0,0,0,0
20/03/2023 10:46,2022,1,WESTERN EUROPE-EU,DENMARK,2,JERSEY,SONDERBORG,922,752,170,0,0,0,0
20/03/2023 10:46,2022,1,WESTERN EUROPE-EU,DENMARK,2,LIVERPOOL (JOHN LENNON),BILLUND,138,0,138,0,0,0,0
20/03/2023 10:46,2022,1,WESTERN EUROPE-EU,DENMARK,2,LIVERPOOL (JOHN LENNON),COPENHAGEN,7329,7201,128,2940,2940,0,149.28571
20/03/2023 10:46,2022,1,WESTERN EUROPE-EU,DENMARK,2,MANCHESTER,BILLUND,49000,49000,0,4356,4155,201,1024.88522
20/03/2023 10:46,2022,1,WESTERN EUROPE-EU,DENMARK,2,MANCHESTER,COPENHAGEN,295428,294723,705,69923,69923,0,322.50476
20/03/2023 10:46,2022,1,WESTERN EUROPE-EU,DENMARK,2,MANCHESTER,ESBJERG,0,0,0,35,0,35,-100
20/03/2023 10:46,2022,1,WESTERN EUROPE-EU,DENMARK,2,MANCHESTER,ODENSE,249,0,249,0,0,0,0
20/03/2023 10:46,2022,1,WESTERN EUROPE-EU,DENMARK,2,MANCHESTER,ROSKILDE,0,0,0,20,0,20,-100
20/03/2023 10:46,2022,1,WESTERN EUROPE-EU,DENMARK,2,NEWCASTLE,COPENHAGEN,1662,1662,0,674,649,25,146.58754
20/03/2023 10:46,2022,1,WESTERN EUROPE-EU,DENMARK,2,NORWICH,BILLUND,0,0,0,52,0,52,-100
20/03/2023 10:46,2022,1,WESTERN EUROPE-EU,DENMARK,2,SOUTHAMPTON,ESBJERG,65,65,0,0,0,0,0
20/03/2023 10:46,2022,1,WESTERN EUROPE-EU,DENMARK,2,TEESSIDE INTERNATIONAL AIRPORT,ESBJERG,0,0,0,405,0,405,-100
20/03/2023 10:46,2022,1,WESTERN EUROPE-EU,DENMARK,2,TEESSIDE INTERNATIONAL AIRPORT,KARUP,380,0,380,0,0,0,0
20/03/2023 10:46,2022,1,WESTERN EUROPE-EU,FINLAND,1,GATWICK,ENONTEKIO,5221,0,5221,2988,0,2988,74.73226
20/03/2023 10:46,2022,1,WESTERN EUROPE-EU,FINLAND,1,GATWICK,HELSINKI,74311,74311,0,6275,6275,0,1084.23904
20/03/2023 10:46,2022,1,WESTERN EUROPE-EU,FINLAND,1,GATWICK,IVALO,8118,0,8118,6423,0,6423,26.38954
20/03/2023 10:46,2022,1,WESTERN EUROPE-EU,FINLAND,1,GATWICK,KITTILA,16571,0,16571,10576,407,10169,56.68495
20/03/2023 10:46,2022,1,WESTERN EUROPE-EU,FINLAND,1,GATWICK,KUUSAMO,7241,0,7241,4000,0,4000,81.025
20/03/2023 10:46,2022,1,WESTERN EUROPE-EU,FINLAND,1,GATWICK,ROVANIEMI,25475,13094,12381,16893,6118,10775,50.80211
20/03/2023 10:46,2022,1,WESTERN EUROPE-EU,FINLAND,1,HEATHROW,HELSINKI,430778,430778,0,141684,141684,0,204.04139
20/03/2023 10:46,2022,1,WESTERN EUROPE-EU,FINLAND,1,HEATHROW,KITTILA,2319,0,2319,2007,0,2007,15.54559
20/03/2023 10:46,2022,1,WESTERN EUROPE-EU,FINLAND,1,LUTON,IVALO,866,0,866,803,0,803,7.84558
20/03/2023 10:46,2022,1,WESTERN EUROPE-EU,FINLAND,1,STANSTED,ENONTEKIO,2068,0,2068,1926,0,1926,7.37279
20/03/2023 10:46,2022,1,WESTERN EUROPE-EU,FINLAND,1,STANSTED,HELSINKI,112415,112415,0,15326,15326,0,633.4921
20/03/2023 10:46,2022,1,WESTERN EUROPE-EU,FINLAND,1,STANSTED,IVALO,3034,0,3034,2160,0,2160,40.46296
20/03/2023 10:46,2022,1,WESTERN EUROPE-EU,FINLAND,1,STANSTED,KITTILA,559,191,368,240,0,240,132.91667
20/03/2023 10:46,2022,1,WESTERN EUROPE-EU,FINLAND,1,STANSTED,KUUSAMO,4010,0,4010,2397,0,2397,67.29245
20/03/2023 10:46,2022,1,WESTERN EUROPE-EU,FINLAND,1,STANSTED,ROVANIEMI,12114,11946,168,166,0,166,7197.59036
20/03/2023 10:46,2022,1,WESTERN EUROPE-EU,FINLAND,1,STANSTED,TAMPERE,26524,26524,0,2317,2317,0,1044.75615
20/03/2023 10:46,2022,1,WESTERN EUROPE-EU,FINLAND,2,ABERDEEN,ENONTEKIO,0,0,0,718,0,718,-100
20/03/2023 10:46,2022,1,WESTERN EUROPE-EU,FINLAND,2,BELFAST INTERNATIONAL,ENONTEKIO,744,0,744,1436,0,1436,-48.18942
20/03/2023 10:46,2022,1,WESTERN EUROPE-EU,FINLAND,2,BELFAST INTERNATIONAL,IVALO,13,0,13,0,0,0,0
20/03/2023 10:46,2022,1,WESTERN EUROPE-EU,FINLAND,2,BELFAST INTERNATIONAL,MARIEHAMN,0,0,0,56,0,56,-100
20/03/2023 10:46,2022,1,WESTERN EUROPE-EU,FINLAND,2,BELFAST INTERNATIONAL,ROVANIEMI,378,0,378,0,0,0,0
20/03/2023 10:46,2022,1,WESTERN EUROPE-EU,FINLAND,2,BIGGIN HILL,HELSINKI,0,0,0,13,0,13,-100
20/03/2023 10:46,2022,1,WESTERN EUROPE-EU,FINLAND,2,BIGGIN HILL,KITTILA,16,0,16,0,0,0,0
20/03/2023 10:46,2022,1,WESTERN EUROPE-EU,FINLAND,2,BIGGIN HILL,ROVANIEMI,32,0,32,0,0,0,0
20/03/2023 10:46,2022,1,WESTERN EUROPE-EU,FINLAND,2,BIGGIN HILL,TAMPERE,10,0,10,0,0,0,0
20/03/2023 10:46,2022,1,WESTERN EUROPE-EU,FINLAND,2,BIRMINGHAM,ENONTEKIO,3326,0,3326,1883,0,1883,76.63303
20/03/2023 10:46,2022,1,WESTERN EUROPE-EU,FINLAND,2,BIRMINGHAM,IVALO,4867,0,4867,4231,0,4231,15.03191
20/03/2023 10:46,2022,1,WESTERN EUROPE-EU,FINLAND,2,BIRMINGHAM,KITTILA,3741,0,3741,2826,0,2826,32.37792
20/03/2023 10:46,2022,1,WESTERN EUROPE-EU,FINLAND,2,BIRMINGHAM,KUUSAMO,1131,0,1131,1074,0,1074,5.30726
20/03/2023 10:46,2022,1,WESTERN EUROPE-EU,FINLAND,2,BIRMINGHAM,ROVANIEMI,2629,0,2629,2363,0,2363,11.25688
20/03/2023 10:46,2022,1,WESTERN EUROPE-EU,FINLAND,2,BIRMINGHAM,TAMPERE,43,0,43,0,0,0,0
20/03/2023 10:46,2022,1,WESTERN EUROPE-EU,FINLAND,2,BOURNEMOUTH,ENONTEKIO,455,0,455,0,0,0,0
20/03/2023 10:46,2022,1,WESTERN EUROPE-EU,FINLAND,2,BOURNEMOUTH,IVALO,437,0,437,428,0,428,2.1028
20/03/2023 10:46,2022,1,WESTERN EUROPE-EU,FINLAND,2,BOURNEMOUTH,TURKU,85,0,85,0,0,0,0
20/03/2023 10:46,2022,1,WESTERN EUROPE-EU,FINLAND,2,BRISTOL,ENONTEKIO,2529,0,2529,1382,0,1382,82.99566
20/03/2023 10:46,2022,1,WESTERN EUROPE-EU,FINLAND,2,BRISTOL,IVALO,2138,0,2138,1547,0,1547,38.20297
20/03/2023 10:46,2022,1,WESTERN EUROPE-EU,FINLAND,2,BRISTOL,KITTILA,6832,42,6790,5332,6,5326,28.13203
20/03/2023 10:46,2022,1,WESTERN EUROPE-EU,FINLAND,2,BRISTOL,ROVANIEMI,6429,3799,2630,2369,0,2369,171.38033
20/03/2023 10:46,2022,1,WESTERN EUROPE-EU,FINLAND,2,CARDIFF WALES,ENONTEKIO,569,0,569,342,0,342,66.37427
20/03/2023 10:46,2022,1,WESTERN EUROPE-EU,FINLAND,2,CARDIFF WALES,IVALO,431,0,431,363,0,363,18.73278
20/03/2023 10:46,2022,1,WESTERN EUROPE-EU,FINLAND,2,CARDIFF WALES,PORI,0,0,0,36,0,36,-100
20/03/2023 10:46,2022,1,WESTERN EUROPE-EU,FINLAND,2,CARDIFF WALES,TURKU,0,0,0,37,0,37,-100
20/03/2023 10:46,2022,1,WESTERN EUROPE-EU,FINLAND,2,DONCASTER SHEFFIELD,ENONTEKIO,309,0,309,318,0,318,-2.83019
20/03/2023 10:46,2022,1,WESTERN EUROPE-EU,FINLAND,2,DONCASTER SHEFFIELD,KITTILA,0,0,0,2724,0,2724,-100
20/03/2023 10:46,2022,1,WESTERN EUROPE-EU,FINLAND,2,EAST MIDLANDS INTERNATIONAL,ENONTEKIO,541,0,541,704,0,704,-23.15341
20/03/2023 10:46,2022,1,WESTERN EUROPE-EU,FINLAND,2,EAST MIDLANDS INTERNATIONAL,IVALO,868,0,868,0,0,0,0
20/03/2023 10:46,2022,1,WESTERN EUROPE-EU,FINLAND,2,EAST MIDLANDS INTERNATIONAL,KITTILA,3168,0,3168,2718,0,2718,16.55629
20/03/2023 10:46,2022,1,WESTERN EUROPE-EU,FINLAND,2,EAST MIDLANDS INTERNATIONAL,ROVANIEMI,0,0,0,180,0,180,-100
20/03/2023 10:46,2022,1,WESTERN EUROPE-EU,FINLAND,2,EDINBURGH,ENONTEKIO,1319,189,1130,738,0,738,78.72629
20/03/2023 10:46,2022,1,WESTERN EUROPE-EU,FINLAND,2,EDINBURGH,HELSINKI,33201,33201,0,9948,9948,0,233.74548
20/03/2023 10:46,2022,1,WESTERN EUROPE-EU,FINLAND,2,EDINBURGH,IVALO,849,0,849,388,0,388,118.81443
20/03/2023 10:46,2022,1,WESTERN EUROPE-EU,FINLAND,2,EDINBURGH,KITTILA,0,0,0,2231,0,2231,-100
20/03/2023 10:46,2022,1,WESTERN EUROPE-EU,FINLAND,2,EXETER,ENONTEKIO,621,0,621,0,0,0,0
20/03/2023 10:46,2022,1,WESTERN EUROPE-EU,FINLAND,2,GLASGOW,ENONTEKIO,1114,0,1114,1442,0,1442,-22.74619
20/03/2023 10:46,2022,1,WESTERN EUROPE-EU,FINLAND,2,GLASGOW,IVALO,430,0,430,392,0,392,9.69388
20/03/2023 10:46,2022,1,WESTERN EUROPE-EU,FINLAND,2,GLASGOW,KITTILA,3351,0,3351,342,0,342,879.82456
20/03/2023 10:46,2022,1,WESTERN EUROPE-EU,FINLAND,2,HUMBERSIDE,ENONTEKIO,1318,0,1318,735,0,735,79.31973
20/03/2023 10:46,2022,1,WESTERN EUROPE-EU,FINLAND,2,JERSEY,ENONTEKIO,35,0,35,0,0,0,0
20/03/2023 10:46,2022,1,WESTERN EUROPE-EU,FINLAND,2,LEEDS BRADFORD,ENONTEKIO,1848,0,1848,174,0,174,962.06897
20/03/2023 10:46,2022,1,WESTERN EUROPE-EU,FINLAND,2,LEEDS BRADFORD,IVALO,1871,183,1688,2076,0,2076,-9.87476
20/03/2023 10:46,2022,1,WESTERN EUROPE-EU,FINLAND,2,LIVERPOOL (JOHN LENNON),ENONTEKIO,370,0,370,360,0,360,2.77778
20/03/2023 10:46,2022,1,WESTERN EUROPE-EU,FINLAND,2,LIVERPOOL (JOHN LENNON),IVALO,436,0,436,383,0,383,13.83812
20/03/2023 10:46,2022,1,WESTERN EUROPE-EU,FINLAND,2,MANCHESTER,ENONTEKIO,4324,0,4324,3179,0,3179,36.01762
20/03/2023 10:46,2022,1,WESTERN EUROPE-EU,FINLAND,2,MANCHESTER,HELSINKI,66740,66740,0,21085,21085,0,216.52834
20/03/2023 10:46,2022,1,WESTERN EUROPE-EU,FINLAND,2,MANCHESTER,IVALO,10518,0,10518,10423,0,10423,0.91145
20/03/2023 10:46,2022,1,WESTERN EUROPE-EU,FINLAND,2,MANCHESTER,KITTILA,19756,0,19756,11958,0,11958,65.21157
20/03/2023 10:46,2022,1,WESTERN EUROPE-EU,FINLAND,2,MANCHESTER,KUUSAMO,10236,0,10236,5102,0,5102,100.62721
20/03/2023 10:46,2022,1,WESTERN EUROPE-EU,FINLAND,2,MANCHESTER,ROVANIEMI,9982,3866,6116,5778,0,5778,72.75874
20/03/2023 10:46,2022,1,WESTERN EUROPE-EU,FINLAND,2,NEWCASTLE,ENONTEKIO,1226,1115,111,364,364,0,236.81319
20/03/2023 10:46,2022,1,WESTERN EUROPE-EU,FINLAND,2,NEWCASTLE,IVALO,858,858,0,758,397,361,13.19261
20/03/2023 10:46,2022,1,WESTERN EUROPE-EU,FINLAND,2,NEWCASTLE,KITTILA,376,376,0,324,324,0,16.04938
20/03/2023 10:46,2022,1,WESTERN EUROPE-EU,FINLAND,2,NEWCASTLE,ROVANIEMI,2602,2602,0,2397,2397,0,8.55236
20/03/2023 10:46,2022,1,WESTERN EUROPE-EU,FINLAND,2,NORWICH,ENONTEKIO,662,284,378,0,0,0,0
20/03/2023 10:46,2022,1,WESTERN EUROPE-EU,FINLAND,2,TEESSIDE INTERNATIONAL AIRPORT,ENONTEKIO,0,0,0,342,0,342,-100
20/03/2023 10:46,2022,1,WESTERN EUROPE-EU,FRANCE,1,GATWICK,BASTIA,11483,11483,0,0,0,0,0
20/03/2023 10:46,2022,1,WESTERN EUROPE-EU,FRANCE,1,GATWICK,BIARRITZ,32523,32523,0,0,0,0,0
20/03/2023 10:46,2022,1,WESTERN EUROPE-EU,FRANCE,1,GATWICK,BORDEAUX,246937,246937,0,25799,25799,0,857.15725
20/03/2023 10:46,2022,1,WESTERN EUROPE-EU,FRANCE,1,GATWICK,CHALONS (VATRY),53,0,53,0,0,0,0
20/03/2023 10:46,2022,1,WESTERN EUROPE-EU,FRANCE,1,GATWICK,CHAMBERY,35222,0,35222,1102,0,1102,3096.18875
20/03/2023 10:46,2022,1,WESTERN EUROPE-EU,FRANCE,1,GATWICK,FIGARI,4730,4730,0,1204,1204,0,292.85714
20/03/2023 10:46,2022,1,WESTERN EUROPE-EU,FRANCE,1,GATWICK,GRENOBLE,35772,19112,16660,1726,1308,418,1972.53766
20/03/2023 10:46,2022,1,WESTERN EUROPE-EU,FRANCE,1,GATWICK,LA ROCHELLE,21593,21593,0,0,0,0,0
20/03/2023 10:46,2022,1,WESTERN EUROPE-EU,FRANCE,1,GATWICK,LILLE,176,0,176,0,0,0,0
20/03/2023 10:46,2022,1,WESTERN EUROPE-EU,FRANCE,1,GATWICK,LIMOGES,13554,13554,0,0,0,0,0
20/03/2023 10:46,2022,1,WESTERN EUROPE-EU,FRANCE,1,GATWICK,LYON,181348,167068,14280,24234,23890,344,648.32054
20/03/2023 10:46,2022,1,WESTERN EUROPE-EU,FRANCE,1,GATWICK,LYON(BRON),0,0,0,8,0,8,-100
20/03/2023 10:46,2022,1,WESTERN EUROPE-EU,FRANCE,1,GATWICK,MARSEILLE,117607,117607,0,16632,16632,0,607.11279
20/03/2023 10:46,2022,1,WESTERN EUROPE-EU,FRANCE,1,GATWICK,MONTPELLIER,114145,113821,324,17788,17788,0,541.69665
20/03/2023 10:46,2022,1,WESTERN EUROPE-EU,FRANCE,1,GATWICK,NANTES,107538,107538,0,23635,23635,0,354.99471
20/03/2023 10:46,2022,1,WESTERN EUROPE-EU,FRANCE,1,GATWICK,NICE,449190,447747,1443,60569,60565,4,641.617
20/03/2023 10:46,2022,1,WESTERN EUROPE-EU,FRANCE,1,GATWICK,PARIS (CHARLES DE GAULLE),309910,309910,0,40486,40486,0,665.47449
20/03/2023 10:46,2022,1,WESTERN EUROPE-EU,FRANCE,1,GATWICK,PARIS (LE BOURGET),50,0,50,2,0,2,2400
20/03/2023 10:46,2022,1,WESTERN EUROPE-EU,FRANCE,1,GATWICK,PARIS (ORLY),205398,205398,0,10468,10468,0,1862.15132
20/03/2023 10:46,2022,1,WESTERN EUROPE-EU,FRANCE,1,GATWICK,PAU,0,0,0,92,0,92,-100
20/03/2023 10:46,2022,1,WESTERN EUROPE-EU,FRANCE,1,GATWICK,RENNES,24327,24327,0,0,0,0,0
20/03/2023 10:46,2022,1,WESTERN EUROPE-EU,FRANCE,1,GATWICK,TOULON / HYERES,8816,8816,0,0,0,0,0
20/03/2023 10:46,2022,1,WESTERN EUROPE-EU,FRANCE,1,GATWICK,TOULOUSE (BLAGNAC),100624,91269,9355,15731,15491,240,539.65419
20/03/2023 10:46,2022,1,WESTERN EUROPE-EU,FRANCE,1,HEATHROW,BASTIA,4141,4141,0,183,183,0,2162.84153
20/03/2023 10:46,2022,1,WESTERN EUROPE-EU,FRANCE,1,HEATHROW,BORDEAUX,357,357,0,14475,14475,0,-97.53368
20/03/2023 10:46,2022,1,WESTERN EUROPE-EU,FRANCE,1,HEATHROW,FIGARI,8908,8908,0,2721,2721,0,227.37964
20/03/2023 10:46,2022,1,WESTERN EUROPE-EU,FRANCE,1,HEATHROW,GRENOBLE,18883,10644,8239,1138,1138,0,1559.31459
20/03/2023 10:46,2022,1,WESTERN EUROPE-EU,FRANCE,1,HEATHROW,LYON,194108,189997,4111,37022,37022,0,424.30447
20/03/2023 10:46,2022,1,WESTERN EUROPE-EU,FRANCE,1,HEATHROW,MARSEILLE,196559,196559,0,51798,51798,0,279.47218
20/03/2023 10:46,2022,1,WESTERN EUROPE-EU,FRANCE,1,HEATHROW,MONTPELLIER,0,0,0,124,124,0,-100
20/03/2023 10:46,2022,1,WESTERN EUROPE-EU,FRANCE,1,HEATHROW,NICE,460199,460199,0,197925,197403,522,132.51181
20/03/2023 10:46,2022,1,WESTERN EUROPE-EU,FRANCE,1,HEATHROW,PARIS (CHARLES DE GAULLE),917541,917266,275,342089,341998,91,168.21704
20/03/2023 10:46,2022,1,WESTERN EUROPE-EU,FRANCE,1,HEATHROW,TOULOUSE (BLAGNAC),175269,174983,286,38750,38750,0,352.3071
20/03/2023 10:46,2022,1,WESTERN EUROPE-EU,FRANCE,1,LONDON CITY,BERGERAC,12772,12772,0,2617,2617,0,388.03974
20/03/2023 10:46,2022,1,WESTERN EUROPE-EU,FRANCE,1,LONDON CITY,CHAMBERY,3770,3770,0,0,0,0,0
20/03/2023 10:46,2022,1,WESTERN EUROPE-EU,FRANCE,1,LONDON CITY,NICE,55586,55586,0,15457,15457,0,259.617
20/03/2023 10:46,2022,1,WESTERN EUROPE-EU,FRANCE,1,LONDON CITY,QUIMPER,6790,6790,0,0,0,0,0
20/03/2023 10:46,2022,1,WESTERN EUROPE-EU,FRANCE,1,LUTON,BEZIERS,19415,19415,0,7720,7720,0,151.48964
20/03/2023 10:46,2022,1,WESTERN EUROPE-EU,FRANCE,1,LUTON,BORDEAUX,45024,45024,0,631,631,0,7035.34073
20/03/2023 10:46,2022,1,WESTERN EUROPE-EU,FRANCE,1,LUTON,GRENOBLE,11722,11722,0,1215,1215,0,864.77366
20/03/2023 10:46,2022,1,WESTERN EUROPE-EU,FRANCE,1,LUTON,LYON,68206,68206,0,4731,4731,0,1341.68252
20/03/2023 10:46,2022,1,WESTERN EUROPE-EU,FRANCE,1,LUTON,MARSEILLE,357,0,357,64,64,0,457.8125
20/03/2023 10:46,2022,1,WESTERN EUROPE-EU,FRANCE,1,LUTON,MONTPELLIER,5641,5641,0,859,859,0,556.69383
20/03/2023 10:46,2022,1,WESTERN EUROPE-EU,FRANCE,1,LUTON,NANTES,177,177,0,0,0,0,0
20/03/2023 10:46,2022,1,WESTERN EUROPE-EU,FRANCE,1,LUTON,NICE,72670,72670,0,8596,8596,0,745.39321
20/03/2023 10:46,2022,1,WESTERN EUROPE-EU,FRANCE,1,LUTON,PARIS (CHARLES DE GAULLE),243990,243990,0,21425,21425,0,1038.8098
20/03/2023 10:46,2022,1,WESTERN EUROPE-EU,FRANCE,1,LUTON,PARIS (LE BOURGET),135,135,0,0,0,0,0
20/03/2023 10:46,2022,1,WESTERN EUROPE-EU,FRANCE,1,LUTON,TOULOUSE (BLAGNAC),104,104,0,160,0,160,-35
20/03/2023 10:46,2022,1,WESTERN EUROPE-EU,FRANCE,1,SOUTHEND,BREST,0,0,0,3979,3979,0,-100
20/03/2023 10:46,2022,1,WESTERN EUROPE-EU,FRANCE,1,SOUTHEND,MARSEILLE,232,0,232,0,0,0,0
20/03/2023 10:46,2022,1,WESTERN EUROPE-EU,FRANCE,1,STANSTED,AJACCIO,5436,5436,0,0,0,0,0
20/03/2023 10:46,2022,1,WESTERN EUROPE-EU,FRANCE,1,STANSTED,BERGERAC,66883,66883,0,18668,18668,0,258.27619
20/03/2023 10:46,2022,1,WESTERN EUROPE-EU,FRANCE,1,STANSTED,BEZIERS,24847,24847,0,4980,4980,0,398.93574
20/03/2023 10:46,2022,1,WESTERN EUROPE-EU,FRANCE,1,STANSTED,BIARRITZ,71199,71199,0,28375,28375,0,150.92159
20/03/2023 10:46,2022,1,WESTERN EUROPE-EU,FRANCE,1,STANSTED,BORDEAUX,82483,82483,0,26971,26935,36,205.82107
20/03/2023 10:46,2022,1,WESTERN EUROPE-EU,FRANCE,1,STANSTED,BRIVE-LA-GAILLARDE,14989,14989,0,3814,3814,0,292.99948
20/03/2023 10:46,2022,1,WESTERN EUROPE-EU,FRANCE,1,STANSTED,CALVI,126,126,0,0,0,0,0
20/03/2023 10:46,2022,1,WESTERN EUROPE-EU,FRANCE,1,STANSTED,CARCASSONNE,56336,56336,0,13232,13232,0,325.75574
20/03/2023 10:46,2022,1,WESTERN EUROPE-EU,FRANCE,1,STANSTED,CHAMBERY,9330,5224,4106,193,0,193,4734.19689
20/03/2023 10:46,2022,1,WESTERN EUROPE-EU,FRANCE,1,STANSTED,CLERMONT FERRAND,53,53,0,0,0,0,0
20/03/2023 10:46,2022,1,WESTERN EUROPE-EU,FRANCE,1,STANSTED,DOLE,323,323,0,93,93,0,247.31183
20/03/2023 10:46,2022,1,WESTERN EUROPE-EU,FRANCE,1,STANSTED,GRENOBLE,16599,15728,871,643,643,0,2481.493
20/03/2023 10:46,2022,1,WESTERN EUROPE-EU,FRANCE,1,STANSTED,LA ROCHELLE,37161,37161,0,11081,11081,0,235.35782
20/03/2023 10:46,2022,1,WESTERN EUROPE-EU,FRANCE,1,STANSTED,LIMOGES,62034,62034,0,21381,21381,0,190.1361
20/03/2023 10:46,2022,1,WESTERN EUROPE-EU,FRANCE,1,STANSTED,LYON,1098,0,1098,112,0,112,880.35714
20/03/2023 10:46,2022,1,WESTERN EUROPE-EU,FRANCE,1,STANSTED,MARSEILLE,148838,148767,71,54236,54236,0,174.42658
20/03/2023 10:46,2022,1,WESTERN EUROPE-EU,FRANCE,1,STANSTED,MONTPELLIER,372,372,0,0,0,0,0
20/03/2023 10:46,2022,1,WESTERN EUROPE-EU,FRANCE,1,STANSTED,NANTES,81383,81383,0,11851,11851,0,586.71842
20/03/2023 10:46,2022,1,WESTERN EUROPE-EU,FRANCE,1,STANSTED,NICE,57789,57789,0,3634,3634,0,1490.23115
20/03/2023 10:46,2022,1,WESTERN EUROPE-EU,FRANCE,1,STANSTED,NIMES,8628,8628,0,6185,6185,0,39.49879
20/03/2023 10:46,2022,1,WESTERN EUROPE-EU,FRANCE,1,STANSTED,PARIS (ORLY),2581,2581,0,0,0,0,0
20/03/2023 10:46,2022,1,WESTERN EUROPE-EU,FRANCE,1,STANSTED,PERPIGNAN,34605,34605,0,6254,6254,0,453.32587
20/03/2023 10:46,2022,1,WESTERN EUROPE-EU,FRANCE,1,STANSTED,POITIERS,41628,41628,0,11226,11226,0,270.81774
20/03/2023 10:46,2022,1,WESTERN EUROPE-EU,FRANCE,1,STANSTED,RODEZ,11412,11412,0,1708,1708,0,568.14988
20/03/2023 10:46,2022,1,WESTERN EUROPE-EU,FRANCE,1,STANSTED,TARBES-LOURDES INTERNATIONAL,55176,53195,1981,8111,8111,0,580.26137
20/03/2023 10:46,2022,1,WESTERN EUROPE-EU,FRANCE,1,STANSTED,TOULOUSE (BLAGNAC),142781,142781,0,37072,37072,0,285.14512
20/03/2023 10:46,2022,1,WESTERN EUROPE-EU,FRANCE,1,STANSTED,TOURS,35981,35981,0,2820,2820,0,1175.92199
20/03/2023 10:46,2022,1,WESTERN EUROPE-EU,FRANCE,2,BELFAST CITY (GEORGE BEST),PARIS (LE BOURGET),4,0,4,0,0,0,0
20/03/2023 10:46,2022,1,WESTERN EUROPE-EU,FRANCE,2,BELFAST INTERNATIONAL,BORDEAUX,5686,5686,0,0,0,0,0
20/03/2023 10:46,2022,1,WESTERN EUROPE-EU,FRANCE,2,BELFAST INTERNATIONAL,CLERMONT FERRAND,82,0,82,98,0,98,-16.32653
20/03/2023 10:46,2022,1,WESTERN EUROPE-EU,FRANCE,2,BELFAST INTERNATIONAL,LA ROCHELLE,298,0,298,0,0,0,0
20/03/2023 10:46,2022,1,WESTERN EUROPE-EU,FRANCE,2,BELFAST INTERNATIONAL,LYON,3294,3294,0,646,646,0,409.90712
20/03/2023 10:46,2022,1,WESTERN EUROPE-EU,FRANCE,2,BELFAST INTERNATIONAL,NICE,11546,11543,3,0,0,0,0
20/03/2023 10:46,2022,1,WESTERN EUROPE-EU,FRANCE,2,BELFAST INTERNATIONAL,PARIS (CHARLES DE GAULLE),77049,77049,0,7041,7041,0,994.29058
20/03/2023 10:46,2022,1,WESTERN EUROPE-EU,FRANCE,2,BELFAST INTERNATIONAL,PARIS (ORLY),496,323,173,288,288,0,72.22222
20/03/2023 10:46,2022,1,WESTERN EUROPE-EU,FRANCE,2,BELFAST INTERNATIONAL,TARBES-LOURDES INTERNATIONAL,1716,0,1716,0,0,0,0
20/03/2023 10:46,2022,1,WESTERN EUROPE-EU,FRANCE,2,BELFAST INTERNATIONAL,TOULOUSE (BLAGNAC),463,0,463,0,0,0,0
20/03/2023 10:46,2022,1,WESTERN EUROPE-EU,FRANCE,2,BIGGIN HILL,AVIGNON,5,0,5,0,0,0,0
20/03/2023 10:46,2022,1,WESTERN EUROPE-EU,FRANCE,2,BIGGIN HILL,BERGERAC,0,0,0,77,0,77,-100
20/03/2023 10:46,2022,1,WESTERN EUROPE-EU,FRANCE,2,BIGGIN HILL,BEZIERS,0,0,0,2,0,2,-100
20/03/2023 10:46,2022,1,WESTERN EUROPE-EU,FRANCE,2,BIGGIN HILL,BIARRITZ,12,0,12,0,0,0,0
20/03/2023 10:46,2022,1,WESTERN EUROPE-EU,FRANCE,2,BIGGIN HILL,BORDEAUX,3,0,3,0,0,0,0
20/03/2023 10:46,2022,1,WESTERN EUROPE-EU,FRANCE,2,BIGGIN HILL,CAEN,0,0,0,2,0,2,-100
20/03/2023 10:46,2022,1,WESTERN EUROPE-EU,FRANCE,2,BIGGIN HILL,CALVI,8,0,8,0,0,0,0
20/03/2023 10:46,2022,1,WESTERN EUROPE-EU,FRANCE,2,BIGGIN HILL,CANNES,45,0,45,21,0,21,114.28571
20/03/2023 10:46,2022,1,WESTERN EUROPE-EU,FRANCE,2,BIGGIN HILL,CHAMBERY,40,0,40,0,0,0,0
20/03/2023 10:46,2022,1,WESTERN EUROPE-EU,FRANCE,2,BIGGIN HILL,DEAUVILLE,0,0,0,5,0,5,-100
20/03/2023 10:46,2022,1,WESTERN EUROPE-EU,FRANCE,2,BIGGIN HILL,FIGARI,9,0,9,0,0,0,0
20/03/2023 10:46,2022,1,WESTERN EUROPE-EU,FRANCE,2,BIGGIN HILL,GRENOBLE,38,0,38,0,0,0,0
20/03/2023 10:46,2022,1,WESTERN EUROPE-EU,FRANCE,2,BIGGIN HILL,LORIENT,2,0,2,0,0,0,0
20/03/2023 10:46,2022,1,WESTERN EUROPE-EU,FRANCE,2,BIGGIN HILL,LYON,13,0,13,4,0,4,225
20/03/2023 10:46,2022,1,WESTERN EUROPE-EU,FRANCE,2,BIGGIN HILL,LYON(BRON),8,0,8,0,0,0,0
20/03/2023 10:46,2022,1,WESTERN EUROPE-EU,FRANCE,2,BIGGIN HILL,MONTPELLIER,3,0,3,0,0,0,0
20/03/2023 10:46,2022,1,WESTERN EUROPE-EU,FRANCE,2,BIGGIN HILL,NICE,216,0,216,138,0,138,56.52174
20/03/2023 10:46,2022,1,WESTERN EUROPE-EU,FRANCE,2,BIGGIN HILL,PARIS (CHARLES DE GAULLE),0,0,0,6,0,6,-100
20/03/2023 10:46,2022,1,WESTERN EUROPE-EU,FRANCE,2,BIGGIN HILL,PARIS (LE BOURGET),24,0,24,23,0,23,4.34783
20/03/2023 10:46,2022,1,WESTERN EUROPE-EU,FRANCE,2,BIGGIN HILL,STRASBOURG,5,0,5,0,0,0,0
20/03/2023 10:46,2022,1,WESTERN EUROPE-EU,FRANCE,2,BIGGIN HILL,TARBES-LOURDES INTERNATIONAL,1,0,1,0,0,0,0
20/03/2023 10:46,2022,1,WESTERN EUROPE-EU,FRANCE,2,BIGGIN HILL,TOULON / HYERES,88,0,88,4,0,4,2100
20/03/2023 10:46,2022,1,WESTERN EUROPE-EU,FRANCE,2,BIGGIN HILL,VILLACOUBLAY,1,0,1,0,0,0,0
20/03/2023 10:46,2022,1,WESTERN EUROPE-EU,FRANCE,2,BIRMINGHAM,AVIGNON,470,470,0,0,0,0,0
20/03/2023 10:46,2022,1,WESTERN EUROPE-EU,FRANCE,2,BIRMINGHAM,BERGERAC,4837,4837,0,0,0,0,0
20/03/2023 10:46,2022,1,WESTERN EUROPE-EU,FRANCE,2,BIRMINGHAM,BORDEAUX,16578,16578,0,0,0,0,0
20/03/2023 10:46,2022,1,WESTERN EUROPE-EU,FRANCE,2,BIRMINGHAM,BREST,687,687,0,0,0,0,0
20/03/2023 10:46,2022,1,WESTERN EUROPE-EU,FRANCE,2,BIRMINGHAM,CAEN,0,0,0,92,0,92,-100
20/03/2023 10:46,2022,1,WESTERN EUROPE-EU,FRANCE,2,BIRMINGHAM,CHAMBERY,10760,4009,6751,243,0,243,4327.98354
20/03/2023 10:46,2022,1,WESTERN EUROPE-EU,FRANCE,2,BIRMINGHAM,CLERMONT FERRAND,0,0,0,86,0,86,-100
20/03/2023 10:46,2022,1,WESTERN EUROPE-EU,FRANCE,2,BIRMINGHAM,GRENOBLE,9333,9333,0,180,180,0,5085
20/03/2023 10:46,2022,1,WESTERN EUROPE-EU,FRANCE,2,BIRMINGHAM,LA ROCHELLE,307,0,307,0,0,0,0
20/03/2023 10:46,2022,1,WESTERN EUROPE-EU,FRANCE,2,BIRMINGHAM,LYON,1196,105,1091,0,0,0,0
20/03/2023 10:46,2022,1,WESTERN EUROPE-EU,FRANCE,2,BIRMINGHAM,MARSEILLE,50,0,50,87,0,87,-42.52874
20/03/2023 10:46,2022,1,WESTERN EUROPE-EU,FRANCE,2,BIRMINGHAM,NANTES,3388,3388,0,0,0,0,0
20/03/2023 10:46,2022,1,WESTERN EUROPE-EU,FRANCE,2,BIRMINGHAM,NICE,0,0,0,161,0,161,-100
20/03/2023 10:46,2022,1,WESTERN EUROPE-EU,FRANCE,2,BIRMINGHAM,PARIS (CHARLES DE GAULLE),201989,201989,0,54949,54949,0,267.59359
20/03/2023 10:46,2022,1,WESTERN EUROPE-EU,FRANCE,2,BIRMINGHAM,PARIS (ORLY),29330,29330,0,2251,2251,0,1202.97645
20/03/2023 10:46,2022,1,WESTERN EUROPE-EU,FRANCE,2,BIRMINGHAM,PERPIGNAN,17278,17278,0,3983,3983,0,333.79362
20/03/2023 10:46,2022,1,WESTERN EUROPE-EU,FRANCE,2,BIRMINGHAM,RENNES,374,0,374,0,0,0,0
20/03/2023 10:46,2022,1,WESTERN EUROPE-EU,FRANCE,2,BIRMINGHAM,TARBES-LOURDES INTERNATIONAL,1140,0,1140,0,0,0,0
20/03/2023 10:46,2022,1,WESTERN EUROPE-EU,FRANCE,2,BIRMINGHAM,TOULON / HYERES,41,0,41,0,0,0,0
20/03/2023 10:46,2022,1,WESTERN EUROPE-EU,FRANCE,2,BIRMINGHAM,TOULOUSE (BLAGNAC),8064,5043,3021,0,0,0,0
20/03/2023 10:46,2022,1,WESTERN EUROPE-EU,FRANCE,2,BOURNEMOUTH,BERGERAC,9705,9705,0,0,0,0,0
20/03/2023 10:46,2022,1,WESTERN EUROPE-EU,FRANCE,2,BOURNEMOUTH,BORDEAUX,2,2,0,0,0,0,0
20/03/2023 10:46,2022,1,WESTERN EUROPE-EU,FRANCE,2,BOURNEMOUTH,TARBES-LOURDES INTERNATIONAL,170,0,170,0,0,0,0
20/03/2023 10:46,2022,1,WESTERN EUROPE-EU,FRANCE,2,BRISTOL,BERGERAC,7128,7128,0,5593,5593,0,27.44502
20/03/2023 10:46,2022,1,WESTERN EUROPE-EU,FRANCE,2,BRISTOL,BEZIERS,10329,10329,0,6083,6083,0,69.80108
20/03/2023 10:46,2022,1,WESTERN EUROPE-EU,FRANCE,2,BRISTOL,BIARRITZ,2186,2186,0,0,0,0,0
20/03/2023 10:46,2022,1,WESTERN EUROPE-EU,FRANCE,2,BRISTOL,BORDEAUX,40883,40575,308,3329,3233,96,1128.08651
20/03/2023 10:46,2022,1,WESTERN EUROPE-EU,FRANCE,2,BRISTOL,CHAMBERY,7977,4771,3206,422,311,111,1790.28436
20/03/2023 10:46,2022,1,WESTERN EUROPE-EU,FRANCE,2,BRISTOL,GRENOBLE,11368,11000,368,1061,1061,0,971.44204
20/03/2023 10:46,2022,1,WESTERN EUROPE-EU,FRANCE,2,BRISTOL,LA ROCHELLE,2859,2762,97,83,0,83,3344.57831
20/03/2023 10:46,2022,1,WESTERN EUROPE-EU,FRANCE,2,BRISTOL,LIMOGES,7075,7075,0,5691,5691,0,24.3191
20/03/2023 10:46,2022,1,WESTERN EUROPE-EU,FRANCE,2,BRISTOL,LYON,17872,16766,1106,1072,1072,0,1567.16418
20/03/2023 10:46,2022,1,WESTERN EUROPE-EU,FRANCE,2,BRISTOL,MARSEILLE,8934,8934,0,0,0,0,0
20/03/2023 10:46,2022,1,WESTERN EUROPE-EU,FRANCE,2,BRISTOL,MONTPELLIER,0,0,0,90,0,90,-100
20/03/2023 10:46,2022,1,WESTERN EUROPE-EU,FRANCE,2,BRISTOL,NANTES,6854,6854,0,0,0,0,0
20/03/2023 10:46,2022,1,WESTERN EUROPE-EU,FRANCE,2,BRISTOL,NICE,57829,57829,0,10938,10938,0,428.69812
20/03/2023 10:46,2022,1,WESTERN EUROPE-EU,FRANCE,2,BRISTOL,PARIS (CHARLES DE GAULLE),121702,121702,0,18202,18202,0,568.61883
20/03/2023 10:46,2022,1,WESTERN EUROPE-EU,FRANCE,2,BRISTOL,PARIS (LE BOURGET),42,0,42,0,0,0,0
20/03/2023 10:46,2022,1,WESTERN EUROPE-EU,FRANCE,2,BRISTOL,PARIS (ORLY),94432,94432,0,10065,10065,0,838.22156
20/03/2023 10:46,2022,1,WESTERN EUROPE-EU,FRANCE,2,BRISTOL,PERPIGNAN,322,0,322,0,0,0,0
20/03/2023 10:46,2022,1,WESTERN EUROPE-EU,FRANCE,2,BRISTOL,TARBES-LOURDES INTERNATIONAL,160,0,160,0,0,0,0
20/03/2023 10:46,2022,1,WESTERN EUROPE-EU,FRANCE,2,BRISTOL,TOULON / HYERES,246,0,246,0,0,0,0
20/03/2023 10:46,2022,1,WESTERN EUROPE-EU,FRANCE,2,BRISTOL,TOULOUSE (BLAGNAC),62073,61529,544,7842,7842,0,691.54552
20/03/2023 10:46,2022,1,WESTERN EUROPE-EU,FRANCE,2,CARDIFF WALES,BIARRITZ,39,0,39,0,0,0,0
20/03/2023 10:46,2022,1,WESTERN EUROPE-EU,FRANCE,2,CARDIFF WALES,BORDEAUX,766,0,766,0,0,0,0
20/03/2023 10:46,2022,1,WESTERN EUROPE-EU,FRANCE,2,CARDIFF WALES,BRIVE-LA-GAILLARDE,124,0,124,0,0,0,0
20/03/2023 10:46,2022,1,WESTERN EUROPE-EU,FRANCE,2,CARDIFF WALES,GRENOBLE,401,0,401,0,0,0,0
20/03/2023 10:46,2022,1,WESTERN EUROPE-EU,FRANCE,2,CARDIFF WALES,LORIENT,0,0,0,72,0,72,-100
20/03/2023 10:46,2022,1,WESTERN EUROPE-EU,FRANCE,2,CARDIFF WALES,LYON,1433,0,1433,82,0,82,1647.56098
20/03/2023 10:46,2022,1,WESTERN EUROPE-EU,FRANCE,2,CARDIFF WALES,MARSEILLE,597,0,597,0,0,0,0
20/03/2023 10:46,2022,1,WESTERN EUROPE-EU,FRANCE,2,CARDIFF WALES,NANTES,1008,0,1008,0,0,0,0
20/03/2023 10:46,2022,1,WESTERN EUROPE-EU,FRANCE,2,CARDIFF WALES,NICE,0,0,0,98,0,98,-100
20/03/2023 10:46,2022,1,WESTERN EUROPE-EU,FRANCE,2,CARDIFF WALES,PARIS (CHARLES DE GAULLE),1401,0,1401,42,0,42,3235.71429
20/03/2023 10:46,2022,1,WESTERN EUROPE-EU,FRANCE,2,CARDIFF WALES,PARIS (LE BOURGET),237,0,237,215,0,215,10.23256
20/03/2023 10:46,2022,1,WESTERN EUROPE-EU,FRANCE,2,CARDIFF WALES,PARIS (ORLY),19570,19570,0,819,819,0,2289.49939
20/03/2023 10:46,2022,1,WESTERN EUROPE-EU,FRANCE,2,CARDIFF WALES,PAU,127,0,127,0,0,0,0
20/03/2023 10:46,2022,1,WESTERN EUROPE-EU,FRANCE,2,CARDIFF WALES,PERPIGNAN,0,0,0,86,0,86,-100
20/03/2023 10:46,2022,1,WESTERN EUROPE-EU,FRANCE,2,CARDIFF WALES,RENNES,88,0,88,0,0,0,0
20/03/2023 10:46,2022,1,WESTERN EUROPE-EU,FRANCE,2,CARDIFF WALES,SAINT BRIEUC (ARMOR),0,0,0,94,0,94,-100
20/03/2023 10:46,2022,1,WESTERN EUROPE-EU,FRANCE,2,CARDIFF WALES,TOULOUSE (BLAGNAC),1463,0,1463,98,0,98,1392.85714
20/03/2023 10:46,2022,1,WESTERN EUROPE-EU,FRANCE,2,CARDIFF WALES,VALENCE,354,0,354,0,0,0,0
20/03/2023 10:46,2022,1,WESTERN EUROPE-EU,FRANCE,2,DONCASTER SHEFFIELD,BORDEAUX,0,0,0,99,99,0,-100
20/03/2023 10:46,2022,1,WESTERN EUROPE-EU,FRANCE,2,DONCASTER SHEFFIELD,LILLE,123,0,123,0,0,0,0
20/03/2023 10:46,2022,1,WESTERN EUROPE-EU,FRANCE,2,DONCASTER SHEFFIELD,NICE,30,0,30,3,0,3,900
20/03/2023 10:46,2022,1,WESTERN EUROPE-EU,FRANCE,2,DONCASTER SHEFFIELD,PERPIGNAN,341,0,341,295,0,295,15.59322
20/03/2023 10:46,2022,1,WESTERN EUROPE-EU,FRANCE,2,DONCASTER SHEFFIELD,TARBES-LOURDES INTERNATIONAL,299,0,299,0,0,0,0
20/03/2023 10:46,2022,1,WESTERN EUROPE-EU,FRANCE,2,DONCASTER SHEFFIELD,TOULOUSE (BLAGNAC),149,0,149,430,0,430,-65.34884
20/03/2023 10:46,2022,1,WESTERN EUROPE-EU,FRANCE,2,DUNDEE,NICE,2,0,2,1,0,1,100
20/03/2023 10:46,2022,1,WESTERN EUROPE-EU,FRANCE,2,DUNDEE,PARIS (LE BOURGET),4,0,4,6,0,6,-33.33333
20/03/2023 10:46,2022,1,WESTERN EUROPE-EU,FRANCE,2,EAST MIDLANDS INTERNATIONAL,BEAUVAIS,0,0,0,112,112,0,-100
20/03/2023 10:46,2022,1,WESTERN EUROPE-EU,FRANCE,2,EAST MIDLANDS INTERNATIONAL,BERGERAC,11284,11284,0,4448,4448,0,153.68705
20/03/2023 10:46,2022,1,WESTERN EUROPE-EU,FRANCE,2,EAST MIDLANDS INTERNATIONAL,BORDEAUX,0,0,0,81,81,0,-100
20/03/2023 10:46,2022,1,WESTERN EUROPE-EU,FRANCE,2,EAST MIDLANDS INTERNATIONAL,CARCASSONNE,14199,14199,0,2570,2570,0,452.49027
20/03/2023 10:46,2022,1,WESTERN EUROPE-EU,FRANCE,2,EAST MIDLANDS INTERNATIONAL,CHAMBERY,2730,0,2730,0,0,0,0
20/03/2023 10:46,2022,1,WESTERN EUROPE-EU,FRANCE,2,EAST MIDLANDS INTERNATIONAL,CLERMONT FERRAND,85,0,85,0,0,0,0
20/03/2023 10:46,2022,1,WESTERN EUROPE-EU,FRANCE,2,EAST MIDLANDS INTERNATIONAL,LIMOGES,19972,19972,0,9659,9659,0,106.77089
20/03/2023 10:46,2022,1,WESTERN EUROPE-EU,FRANCE,2,EAST MIDLANDS INTERNATIONAL,LYON,286,0,286,0,0,0,0
20/03/2023 10:46,2022,1,WESTERN EUROPE-EU,FRANCE,2,EAST MIDLANDS INTERNATIONAL,MARSEILLE,14441,14441,0,0,0,0,0
20/03/2023 10:46,2022,1,WESTERN EUROPE-EU,FRANCE,2,EAST MIDLANDS INTERNATIONAL,PARIS (CHARLES DE GAULLE),62,0,62,0,0,0,0
20/03/2023 10:46,2022,1,WESTERN EUROPE-EU,FRANCE,2,EAST MIDLANDS INTERNATIONAL,PERPIGNAN,0,0,0,8,8,0,-100
20/03/2023 10:46,2022,1,WESTERN EUROPE-EU,FRANCE,2,EAST MIDLANDS INTERNATIONAL,RENNES,183,0,183,0,0,0,0
20/03/2023 10:46,2022,1,WESTERN EUROPE-EU,FRANCE,2,EAST MIDLANDS INTERNATIONAL,TOULOUSE (BLAGNAC),0,0,0,149,0,149,-100
20/03/2023 10:46,2022,1,WESTERN EUROPE-EU,FRANCE,2,EDINBURGH,BEAUVAIS,51622,51622,0,3662,3662,0,1309.66685
20/03/2023 10:46,2022,1,WESTERN EUROPE-EU,FRANCE,2,EDINBURGH,BEZIERS,17048,17048,0,1959,1959,0,770.23992
20/03/2023 10:46,2022,1,WESTERN EUROPE-EU,FRANCE,2,EDINBURGH,BIARRITZ,354,0,354,0,0,0,0
20/03/2023 10:46,2022,1,WESTERN EUROPE-EU,FRANCE,2,EDINBURGH,BORDEAUX,35637,34214,1423,6879,6879,0,418.05495
20/03/2023 10:46,2022,1,WESTERN EUROPE-EU,FRANCE,2,EDINBURGH,BREST,155,155,0,0,0,0,0
20/03/2023 10:46,2022,1,WESTERN EUROPE-EU,FRANCE,2,EDINBURGH,BRIVE-LA-GAILLARDE,92,0,92,0,0,0,0
20/03/2023 10:46,2022,1,WESTERN EUROPE-EU,FRANCE,2,EDINBURGH,CARCASSONNE,18148,18148,0,1293,1293,0,1303.55762
20/03/2023 10:46,2022,1,WESTERN EUROPE-EU,FRANCE,2,EDINBURGH,CHAMBERY,4921,169,4752,64,0,64,7589.0625
20/03/2023 10:46,2022,1,WESTERN EUROPE-EU,FRANCE,2,EDINBURGH,GRENOBLE,3988,3267,721,235,235,0,1597.02128
20/03/2023 10:46,2022,1,WESTERN EUROPE-EU,FRANCE,2,EDINBURGH,LYON,21627,19190,2437,727,657,70,2874.82806
20/03/2023 10:46,2022,1,WESTERN EUROPE-EU,FRANCE,2,EDINBURGH,MARSEILLE,39294,38527,767,8568,8568,0,358.61345
20/03/2023 10:46,2022,1,WESTERN EUROPE-EU,FRANCE,2,EDINBURGH,NANTES,37334,36508,826,2963,2963,0,1160.00675
20/03/2023 10:46,2022,1,WESTERN EUROPE-EU,FRANCE,2,EDINBURGH,NICE,44457,44457,0,4737,4737,0,838.50538
20/03/2023 10:46,2022,1,WESTERN EUROPE-EU,FRANCE,2,EDINBURGH,NIMES,16302,16302,0,0,0,0,0
20/03/2023 10:46,2022,1,WESTERN EUROPE-EU,FRANCE,2,EDINBURGH,PARIS (CHARLES DE GAULLE),307322,304443,2879,61679,61679,0,398.26035
20/03/2023 10:46,2022,1,WESTERN EUROPE-EU,FRANCE,2,EDINBURGH,PARIS (LE BOURGET),0,0,0,187,0,187,-100
20/03/2023 10:46,2022,1,WESTERN EUROPE-EU,FRANCE,2,EDINBURGH,PARIS (ORLY),31004,31004,0,2084,2084,0,1387.71593
20/03/2023 10:46,2022,1,WESTERN EUROPE-EU,FRANCE,2,EDINBURGH,PAU,268,0,268,0,0,0,0
20/03/2023 10:46,2022,1,WESTERN EUROPE-EU,FRANCE,2,EDINBURGH,POITIERS,15841,15841,0,0,0,0,0
20/03/2023 10:46,2022,1,WESTERN EUROPE-EU,FRANCE,2,EDINBURGH,ST ETIENNE,130,0,130,0,0,0,0
20/03/2023 10:46,2022,1,WESTERN EUROPE-EU,FRANCE,2,EDINBURGH,TARBES-LOURDES INTERNATIONAL,354,0,354,0,0,0,0
20/03/2023 10:46,2022,1,WESTERN EUROPE-EU,FRANCE,2,EDINBURGH,TOULOUSE (BLAGNAC),31081,29403,1678,5776,5776,0,438.10596
20/03/2023 10:46,2022,1,WESTERN EUROPE-EU,FRANCE,2,EDINBURGH,VALENCE,1455,0,1455,0,0,0,0
20/03/2023 10:46,2022,1,WESTERN EUROPE-EU,FRANCE,2,EXETER,CHAMBERY,2321,0,2321,0,0,0,0
20/03/2023 10:46,2022,1,WESTERN EUROPE-EU,FRANCE,2,EXETER,LYON,257,0,257,82,0,82,213.41463
20/03/2023 10:46,2022,1,WESTERN EUROPE-EU,FRANCE,2,EXETER,MONTPELLIER,82,0,82,46,0,46,78.26087
20/03/2023 10:46,2022,1,WESTERN EUROPE-EU,FRANCE,2,GLASGOW,BORDEAUX,6236,6236,0,0,0,0,0
20/03/2023 10:46,2022,1,WESTERN EUROPE-EU,FRANCE,2,GLASGOW,CHAMBERY,3138,0,3138,0,0,0,0
20/03/2023 10:46,2022,1,WESTERN EUROPE-EU,FRANCE,2,GLASGOW,LA ROCHELLE,90,0,90,94,0,94,-4.25532
20/03/2023 10:46,2022,1,WESTERN EUROPE-EU,FRANCE,2,GLASGOW,LYON,524,0,524,545,0,545,-3.85321
20/03/2023 10:46,2022,1,WESTERN EUROPE-EU,FRANCE,2,GLASGOW,MARSEILLE,5354,5354,0,0,0,0,0
20/03/2023 10:46,2022,1,WESTERN EUROPE-EU,FRANCE,2,GLASGOW,MONTPELLIER,0,0,0,88,0,88,-100
20/03/2023 10:46,2022,1,WESTERN EUROPE-EU,FRANCE,2,GLASGOW,PARIS (CHARLES DE GAULLE),105716,105716,0,8140,8140,0,1198.72236
20/03/2023 10:46,2022,1,WESTERN EUROPE-EU,FRANCE,2,GLASGOW,PARIS (LE BOURGET),85,0,85,0,0,0,0
20/03/2023 10:46,2022,1,WESTERN EUROPE-EU,FRANCE,2,GLASGOW,PARIS (ORLY),20670,20670,0,1537,1537,0,1244.82759
20/03/2023 10:46,2022,1,WESTERN EUROPE-EU,FRANCE,2,GLASGOW,PERPIGNAN,97,0,97,0,0,0,0
20/03/2023 10:46,2022,1,WESTERN EUROPE-EU,FRANCE,2,GUERNSEY,BERGERAC,140,140,0,0,0,0,0
20/03/2023 10:46,2022,1,WESTERN EUROPE-EU,FRANCE,2,GUERNSEY,BORDEAUX,0,0,0,123,123,0,-100
20/03/2023 10:46,2022,1,WESTERN EUROPE-EU,FRANCE,2,GUERNSEY,GRENOBLE,607,467,140,0,0,0,0
20/03/2023 10:46,2022,1,WESTERN EUROPE-EU,FRANCE,2,GUERNSEY,NICE,129,129,0,2,0,2,6350
20/03/2023 10:46,2022,1,WESTERN EUROPE-EU,FRANCE,2,GUERNSEY,PARIS (CHARLES DE GAULLE),111,111,0,0,0,0,0
20/03/2023 10:46,2022,1,WESTERN EUROPE-EU,FRANCE,2,GUERNSEY,TOULOUSE (BLAGNAC),1,1,0,0,0,0,0
20/03/2023 10:46,2022,1,WESTERN EUROPE-EU,FRANCE,2,HUMBERSIDE,NICE,0,0,0,30,0,30,-100
20/03/2023 10:46,2022,1,WESTERN EUROPE-EU,FRANCE,2,HUMBERSIDE,PERPIGNAN,229,0,229,106,0,106,116.03774
20/03/2023 10:46,2022,1,WESTERN EUROPE-EU,FRANCE,2,HUMBERSIDE,TOULOUSE (BLAGNAC),80,0,80,34,0,34,135.29412
20/03/2023 10:46,2022,1,WESTERN EUROPE-EU,FRANCE,2,ISLE OF MAN,PARIS (LE BOURGET),80,0,80,0,0,0,0
20/03/2023 10:46,2022,1,WESTERN EUROPE-EU,FRANCE,2,JERSEY,BASTIA,0,0,0,132,132,0,-100
20/03/2023 10:46,2022,1,WESTERN EUROPE-EU,FRANCE,2,JERSEY,CAEN,0,0,0,34,0,34,-100
20/03/2023 10:46,2022,1,WESTERN EUROPE-EU,FRANCE,2,JERSEY,GRENOBLE,440,0,440,0,0,0,0
20/03/2023 10:46,2022,1,WESTERN EUROPE-EU,FRANCE,2,JERSEY,NANTES,0,0,0,35,0,35,-100
20/03/2023 10:46,2022,1,WESTERN EUROPE-EU,FRANCE,2,JERSEY,PARIS (CHARLES DE GAULLE),110,0,110,0,0,0,0
20/03/2023 10:46,2022,1,WESTERN EUROPE-EU,FRANCE,2,JERSEY,RENNES,2537,1838,699,901,0,901,181.57603
20/03/2023 10:46,2022,1,WESTERN EUROPE-EU,FRANCE,2,LEEDS BRADFORD,BEAUVAIS,16876,16876,0,0,0,0,0
20/03/2023 10:46,2022,1,WESTERN EUROPE-EU,FRANCE,2,LEEDS BRADFORD,BERGERAC,5098,5098,0,0,0,0,0
20/03/2023 10:46,2022,1,WESTERN EUROPE-EU,FRANCE,2,LEEDS BRADFORD,CHAMBERY,3828,3828,0,0,0,0,0
20/03/2023 10:46,2022,1,WESTERN EUROPE-EU,FRANCE,2,LEEDS BRADFORD,GRENOBLE,162,162,0,0,0,0,0
20/03/2023 10:46,2022,1,WESTERN EUROPE-EU,FRANCE,2,LEEDS BRADFORD,LIMOGES,18306,18306,0,3787,3787,0,383.39055
20/03/2023 10:46,2022,1,WESTERN EUROPE-EU,FRANCE,2,LEEDS BRADFORD,NICE,5087,5021,66,0,0,0,0
20/03/2023 10:46,2022,1,WESTERN EUROPE-EU,FRANCE,2,LEEDS BRADFORD,PARIS (CHARLES DE GAULLE),47410,47410,0,2478,2478,0,1813.23648
20/03/2023 10:46,2022,1,WESTERN EUROPE-EU,FRANCE,2,LEEDS BRADFORD,PERPIGNAN,409,0,409,70,70,0,484.28571
20/03/2023 10:46,2022,1,WESTERN EUROPE-EU,FRANCE,2,LEEDS BRADFORD,TARBES-LOURDES INTERNATIONAL,289,0,289,0,0,0,0
20/03/2023 10:46,2022,1,WESTERN EUROPE-EU,FRANCE,2,LIVERPOOL (JOHN LENNON),BEAUVAIS,25371,25371,0,1619,1619,0,1467.07844
20/03/2023 10:46,2022,1,WESTERN EUROPE-EU,FRANCE,2,LIVERPOOL (JOHN LENNON),BERGERAC,23674,23674,0,6066,6066,0,290.27366
20/03/2023 10:46,2022,1,WESTERN EUROPE-EU,FRANCE,2,LIVERPOOL (JOHN LENNON),BORDEAUX,147,147,0,0,0,0,0
20/03/2023 10:46,2022,1,WESTERN EUROPE-EU,FRANCE,2,LIVERPOOL (JOHN LENNON),GRENOBLE,1390,1309,81,274,274,0,407.29927
20/03/2023 10:46,2022,1,WESTERN EUROPE-EU,FRANCE,2,LIVERPOOL (JOHN LENNON),NICE,41833,41833,0,4085,4085,0,924.06365
20/03/2023 10:46,2022,1,WESTERN EUROPE-EU,FRANCE,2,LIVERPOOL (JOHN LENNON),PARIS (CHARLES DE GAULLE),13131,8381,4750,0,0,0,0
20/03/2023 10:46,2022,1,WESTERN EUROPE-EU,FRANCE,2,LIVERPOOL (JOHN LENNON),PARIS (LE BOURGET),50,0,50,0,0,0,0
20/03/2023 10:46,2022,1,WESTERN EUROPE-EU,FRANCE,2,LIVERPOOL (JOHN LENNON),PARIS (ORLY),2790,0,2790,0,0,0,0
20/03/2023 10:46,2022,1,WESTERN EUROPE-EU,FRANCE,2,LIVERPOOL (JOHN LENNON),PERPIGNAN,649,0,649,1911,0,1911,-66.03872
20/03/2023 10:46,2022,1,WESTERN EUROPE-EU,FRANCE,2,LIVERPOOL (JOHN LENNON),STRASBOURG,49,0,49,0,0,0,0
20/03/2023 10:46,2022,1,WESTERN EUROPE-EU,FRANCE,2,LIVERPOOL (JOHN LENNON),TARBES-LOURDES INTERNATIONAL,690,0,690,0,0,0,0
20/03/2023 10:46,2022,1,WESTERN EUROPE-EU,FRANCE,2,LIVERPOOL (JOHN LENNON),TOULOUSE (BLAGNAC),156,0,156,110,0,110,41.81818
20/03/2023 10:46,2022,1,WESTERN EUROPE-EU,FRANCE,2,MANCHESTER,BEAUVAIS,58350,58350,0,5950,5950,0,880.67227
20/03/2023 10:46,2022,1,WESTERN EUROPE-EU,FRANCE,2,MANCHESTER,BERGERAC,4423,4423,0,0,0,0,0
20/03/2023 10:46,2022,1,WESTERN EUROPE-EU,FRANCE,2,MANCHESTER,BEZIERS,25257,25257,0,5325,5325,0,374.30986
20/03/2023 10:46,2022,1,WESTERN EUROPE-EU,FRANCE,2,MANCHESTER,BORDEAUX,61066,61066,0,8649,8649,0,606.04694
20/03/2023 10:46,2022,1,WESTERN EUROPE-EU,FRANCE,2,MANCHESTER,CARCASSONNE,38424,38424,0,9761,9761,0,293.64819
20/03/2023 10:46,2022,1,WESTERN EUROPE-EU,FRANCE,2,MANCHESTER,CHAMBERY,23000,8729,14271,503,270,233,4472.56461
20/03/2023 10:46,2022,1,WESTERN EUROPE-EU,FRANCE,2,MANCHESTER,CLERMONT FERRAND,94,94,0,0,0,0,0
20/03/2023 10:46,2022,1,WESTERN EUROPE-EU,FRANCE,2,MANCHESTER,GRENOBLE,13172,13172,0,451,451,0,2820.62084
20/03/2023 10:46,2022,1,WESTERN EUROPE-EU,FRANCE,2,MANCHESTER,LA ROCHELLE,9294,9294,0,108,0,108,8505.55556
20/03/2023 10:46,2022,1,WESTERN EUROPE-EU,FRANCE,2,MANCHESTER,LILLE,106,106,0,0,0,0,0
20/03/2023 10:46,2022,1,WESTERN EUROPE-EU,FRANCE,2,MANCHESTER,LIMOGES,35212,35212,0,12154,12154,0,189.71532
20/03/2023 10:46,2022,1,WESTERN EUROPE-EU,FRANCE,2,MANCHESTER,LYON,9538,8235,1303,973,973,0,880.26721
20/03/2023 10:46,2022,1,WESTERN EUROPE-EU,FRANCE,2,MANCHESTER,MARSEILLE,29104,29104,0,10251,10251,0,183.91376
20/03/2023 10:46,2022,1,WESTERN EUROPE-EU,FRANCE,2,MANCHESTER,MENDE,0,0,0,104,104,0,-100
20/03/2023 10:46,2022,1,WESTERN EUROPE-EU,FRANCE,2,MANCHESTER,NANTES,28359,28260,99,9970,9970,0,184.44333
20/03/2023 10:46,2022,1,WESTERN EUROPE-EU,FRANCE,2,MANCHESTER,NICE,55309,55309,0,6588,6588,0,739.54159
20/03/2023 10:46,2022,1,WESTERN EUROPE-EU,FRANCE,2,MANCHESTER,PARIS (CHARLES DE GAULLE),515019,514877,142,147060,145821,1239,250.21012
20/03/2023 10:46,2022,1,WESTERN EUROPE-EU,FRANCE,2,MANCHESTER,PARIS (LE BOURGET),0,0,0,195,0,195,-100
20/03/2023 10:46,2022,1,WESTERN EUROPE-EU,FRANCE,2,MANCHESTER,PERPIGNAN,286,0,286,148,0,148,93.24324
20/03/2023 10:46,2022,1,WESTERN EUROPE-EU,FRANCE,2,MANCHESTER,TARBES-LOURDES INTERNATIONAL,655,0,655,0,0,0,0
20/03/2023 10:46,2022,1,WESTERN EUROPE-EU,FRANCE,2,MANCHESTER,TOULOUSE (BLAGNAC),6351,0,6351,0,0,0,0
20/03/2023 10:46,2022,1,WESTERN EUROPE-EU,FRANCE,2,NEWCASTLE,GRENOBLE,4076,4076,0,0,0,0,0
20/03/2023 10:46,2022,1,WESTERN EUROPE-EU,FRANCE,2,NEWCASTLE,PARIS (CHARLES DE GAULLE),107904,107904,0,20334,20334,0,430.65801
20/03/2023 10:46,2022,1,WESTERN EUROPE-EU,FRANCE,2,NEWCASTLE,PARIS (ORLY),12228,12228,0,953,953,0,1183.10598
20/03/2023 10:46,2022,1,WESTERN EUROPE-EU,FRANCE,2,NEWCASTLE,PERPIGNAN,0,0,0,84,0,84,-100
20/03/2023 10:46,2022,1,WESTERN EUROPE-EU,FRANCE,2,NEWCASTLE,TOULOUSE (BLAGNAC),77,0,77,124,0,124,-37.90323
20/03/2023 10:46,2022,1,WESTERN EUROPE-EU,FRANCE,2,NORWICH,MARSEILLE,94,0,94,0,0,0,0
20/03/2023 10:46,2022,1,WESTERN EUROPE-EU,FRANCE,2,OXFORD (KIDLINGTON),MARSEILLE,0,0,0,44,44,0,-100
20/03/2023 10:46,2022,1,WESTERN EUROPE-EU,FRANCE,2,OXFORD (KIDLINGTON),NICE,0,0,0,50,50,0,-100
20/03/2023 10:46,2022,1,WESTERN EUROPE-EU,FRANCE,2,SOUTHAMPTON,AVIGNON,901,901,0,0,0,0,0
20/03/2023 10:46,2022,1,WESTERN EUROPE-EU,FRANCE,2,SOUTHAMPTON,BERGERAC,7348,7348,0,1641,1641,0,347.77575
20/03/2023 10:46,2022,1,WESTERN EUROPE-EU,FRANCE,2,SOUTHAMPTON,CHAMBERY,3023,3023,0,0,0,0,0
20/03/2023 10:46,2022,1,WESTERN EUROPE-EU,FRANCE,2,SOUTHAMPTON,LIMOGES,2769,2769,0,0,0,0,0
20/03/2023 10:46,2022,1,WESTERN EUROPE-EU,FRANCE,2,SOUTHAMPTON,NICE,597,499,98,0,0,0,0
20/03/2023 10:46,2022,1,WESTERN EUROPE-EU,FRANCE,2,SOUTHAMPTON,TOULON / HYERES,561,561,0,0,0,0,0
20/03/2023 10:46,2022,1,WESTERN EUROPE-EU,FRANCE,2,TEESSIDE INTERNATIONAL AIRPORT,MARSEILLE,61,0,61,0,0,0,0
20/03/2023 10:46,2022,1,WESTERN EUROPE-EU,FRANCE,2,TEESSIDE INTERNATIONAL AIRPORT,PERPIGNAN,31,0,31,0,0,0,0
20/03/2023 10:46,2022,1,WESTERN EUROPE-EU,FRANCE,2,TEESSIDE INTERNATIONAL AIRPORT,TARBES-LOURDES INTERNATIONAL,376,0,376,0,0,0,0
20/03/2023 10:46,2022,1,WESTERN EUROPE-EU,FRANCE,2,TEESSIDE INTERNATIONAL AIRPORT,TOULOUSE (BLAGNAC),75,0,75,0,0,0,0
20/03/2023 10:46,2022,1,WESTERN EUROPE-EU,GERMANY,1,GATWICK,BERLIN BRANDENBURG,345743,345743,0,55992,55992,0,517.48643
20/03/2023 10:46,2022,1,WESTERN EUROPE-EU,GERMANY,1,GATWICK,BRAUNSCHWEIG,0,0,0,83,0,83,-100
20/03/2023 10:46,2022,1,WESTERN EUROPE-EU,GERMANY,1,GATWICK,COLOGNE BONN,32061,31764,297,0,0,0,0
20/03/2023 10:46,2022,1,WESTERN EUROPE-EU,GERMANY,1,GATWICK,DUSSELDORF,95,0,95,0,0,0,0
20/03/2023 10:46,2022,1,WESTERN EUROPE-EU,GERMANY,1,GATWICK,FRANKFURT MAIN,0,0,0,573,0,573,-100
20/03/2023 10:46,2022,1,WESTERN EUROPE-EU,GERMANY,1,GATWICK,FRIEDRICHSHAFEN,2542,2542,0,161,161,0,1478.88199
20/03/2023 10:46,2022,1,WESTERN EUROPE-EU,GERMANY,1,GATWICK,HAMBURG,79244,79082,162,6979,6979,0,1035.46353
20/03/2023 10:46,2022,1,WESTERN EUROPE-EU,GERMANY,1,GATWICK,MUNICH,132494,132316,178,16927,16882,45,682.73764
20/03/2023 10:46,2022,1,WESTERN EUROPE-EU,GERMANY,1,HEATHROW,BERLIN BRANDENBURG,383555,383555,0,115625,115258,367,231.72324
20/03/2023 10:46,2022,1,WESTERN EUROPE-EU,GERMANY,1,HEATHROW,COLOGNE BONN,108450,108450,0,13264,13264,0,717.62666
20/03/2023 10:46,2022,1,WESTERN EUROPE-EU,GERMANY,1,HEATHROW,DUSSELDORF,410770,410770,0,85072,85072,0,382.84982
20/03/2023 10:46,2022,1,WESTERN EUROPE-EU,GERMANY,1,HEATHROW,FRANKFURT MAIN,1046015,1046015,0,314745,314647,98,232.33729
20/03/2023 10:46,2022,1,WESTERN EUROPE-EU,GERMANY,1,HEATHROW,HAMBURG,382428,382428,0,75620,75602,18,405.72335
20/03/2023 10:46,2022,1,WESTERN EUROPE-EU,GERMANY,1,HEATHROW,HANOVER,85779,85779,0,9208,9208,0,831.57037
20/03/2023 10:46,2022,1,WESTERN EUROPE-EU,GERMANY,1,HEATHROW,LEIPZIG,250,0,250,0,0,0,0
20/03/2023 10:46,2022,1,WESTERN EUROPE-EU,GERMANY,1,HEATHROW,MUNICH,933939,933939,0,201723,201654,69,362.98092
20/03/2023 10:46,2022,1,WESTERN EUROPE-EU,GERMANY,1,HEATHROW,NUREMBERG,47632,47632,0,0,0,0,0
20/03/2023 10:46,2022,1,WESTERN EUROPE-EU,GERMANY,1,HEATHROW,STUTTGART,246956,246956,0,36557,36557,0,575.53683
20/03/2023 10:46,2022,1,WESTERN EUROPE-EU,GERMANY,1,LONDON CITY,BERLIN BRANDENBURG,136281,136281,0,25771,25771,0,428.81534
20/03/2023 10:46,2022,1,WESTERN EUROPE-EU,GERMANY,1,LONDON CITY,DUSSELDORF,118997,118997,0,22385,22385,0,431.59258
20/03/2023 10:46,2022,1,WESTERN EUROPE-EU,GERMANY,1,LONDON CITY,FRANKFURT MAIN,226711,226711,0,39643,39643,0,471.88154
20/03/2023 10:46,2022,1,WESTERN EUROPE-EU,GERMANY,1,LUTON,BERLIN BRANDENBURG,42319,42319,0,7140,7140,0,492.70308
20/03/2023 10:46,2022,1,WESTERN EUROPE-EU,GERMANY,1,LUTON,COLOGNE BONN,343,343,0,0,0,0,0
20/03/2023 10:46,2022,1,WESTERN EUROPE-EU,GERMANY,1,LUTON,FRANKFURT MAIN,173,173,0,0,0,0,0
20/03/2023 10:46,2022,1,WESTERN EUROPE-EU,GERMANY,1,LUTON,HAMBURG,174,174,0,0,0,0,0
20/03/2023 10:46,2022,1,WESTERN EUROPE-EU,GERMANY,1,LUTON,MUNSTER-OSNABRUCK,138,138,0,0,0,0,0
20/03/2023 10:46,2022,1,WESTERN EUROPE-EU,GERMANY,1,LUTON,NIEDERRHEIN,0,0,0,119,0,119,-100
20/03/2023 10:46,2022,1,WESTERN EUROPE-EU,GERMANY,1,LUTON,NUREMBERG,0,0,0,245,245,0,-100
20/03/2023 10:46,2022,1,WESTERN EUROPE-EU,GERMANY,1,LUTON,PADERBORN,429,429,0,0,0,0,0
20/03/2023 10:46,2022,1,WESTERN EUROPE-EU,GERMANY,1,LUTON,STUTTGART,0,0,0,97,97,0,-100
20/03/2023 10:46,2022,1,WESTERN EUROPE-EU,GERMANY,1,STANSTED,BERLIN BRANDENBURG,319487,319487,0,100741,100741,0,217.13701
20/03/2023 10:46,2022,1,WESTERN EUROPE-EU,GERMANY,1,STANSTED,BRAUNSCHWEIG,58,0,58,0,0,0,0
20/03/2023 10:46,2022,1,WESTERN EUROPE-EU,GERMANY,1,STANSTED,BREMEN,139970,139970,0,13253,13253,0,956.13823
20/03/2023 10:46,2022,1,WESTERN EUROPE-EU,GERMANY,1,STANSTED,COLOGNE BONN,243355,243355,0,71380,71380,0,240.92883
20/03/2023 10:46,2022,1,WESTERN EUROPE-EU,GERMANY,1,STANSTED,DORTMUND,62826,62826,0,6979,6979,0,800.21493
20/03/2023 10:46,2022,1,WESTERN EUROPE-EU,GERMANY,1,STANSTED,DRESDEN,36278,36278,0,949,949,0,3722.7608
20/03/2023 10:46,2022,1,WESTERN EUROPE-EU,GERMANY,1,STANSTED,FRANKFURT MAIN,30818,29676,1142,58155,58155,0,-47.00714
20/03/2023 10:46,2022,1,WESTERN EUROPE-EU,GERMANY,1,STANSTED,HAHN,84075,84075,0,0,0,0,0
20/03/2023 10:46,2022,1,WESTERN EUROPE-EU,GERMANY,1,STANSTED,HAMBURG,158188,158188,0,43650,43650,0,262.40092
20/03/2023 10:46,2022,1,WESTERN EUROPE-EU,GERMANY,1,STANSTED,KARLSRUHE/BADEN BADEN,105518,105518,0,14785,14785,0,613.68279
20/03/2023 10:46,2022,1,WESTERN EUROPE-EU,GERMANY,1,STANSTED,LEIPZIG,7723,7723,0,0,0,0,0
20/03/2023 10:46,2022,1,WESTERN EUROPE-EU,GERMANY,1,STANSTED,MEMMINGEN ALLGAU,59946,59946,0,15974,15974,0,275.27232
20/03/2023 10:46,2022,1,WESTERN EUROPE-EU,GERMANY,1,STANSTED,MUNICH,125,0,125,0,0,0,0
20/03/2023 10:46,2022,1,WESTERN EUROPE-EU,GERMANY,1,STANSTED,NIEDERRHEIN,273,273,0,0,0,0,0
20/03/2023 10:46,2022,1,WESTERN EUROPE-EU,GERMANY,1,STANSTED,NUREMBERG,131291,131291,0,11250,11250,0,1067.03111
20/03/2023 10:46,2022,1,WESTERN EUROPE-EU,GERMANY,2,BELFAST INTERNATIONAL,FRANKFURT MAIN,293,0,293,0,0,0,0
20/03/2023 10:46,2022,1,WESTERN EUROPE-EU,GERMANY,2,BELFAST INTERNATIONAL,HANOVER,83,0,83,0,0,0,0
20/03/2023 10:46,2022,1,WESTERN EUROPE-EU,GERMANY,2,BELFAST INTERNATIONAL,MUNICH,106,0,106,0,0,0,0
20/03/2023 10:46,2022,1,WESTERN EUROPE-EU,GERMANY,2,BIGGIN HILL,BERLIN BRANDENBURG,20,0,20,5,0,5,300
20/03/2023 10:46,2022,1,WESTERN EUROPE-EU,GERMANY,2,BIGGIN HILL,BREMEN,0,0,0,4,0,4,-100
20/03/2023 10:46,2022,1,WESTERN EUROPE-EU,GERMANY,2,BIGGIN HILL,COLOGNE BONN,15,0,15,4,0,4,275
20/03/2023 10:46,2022,1,WESTERN EUROPE-EU,GERMANY,2,BIGGIN HILL,DORTMUND,0,0,0,4,0,4,-100
20/03/2023 10:46,2022,1,WESTERN EUROPE-EU,GERMANY,2,BIGGIN HILL,DUSSELDORF,2,0,2,8,0,8,-75
20/03/2023 10:46,2022,1,WESTERN EUROPE-EU,GERMANY,2,BIGGIN HILL,FRANKFURT MAIN,16,0,16,12,0,12,33.33333
20/03/2023 10:46,2022,1,WESTERN EUROPE-EU,GERMANY,2,BIGGIN HILL,HAMBURG,0,0,0,6,0,6,-100
20/03/2023 10:46,2022,1,WESTERN EUROPE-EU,GERMANY,2,BIGGIN HILL,HANOVER,11,0,11,0,0,0,0
20/03/2023 10:46,2022,1,WESTERN EUROPE-EU,GERMANY,2,BIGGIN HILL,KARLSRUHE/BADEN BADEN,2,0,2,0,0,0,0
20/03/2023 10:46,2022,1,WESTERN EUROPE-EU,GERMANY,2,BIGGIN HILL,MUNICH,46,0,46,84,0,84,-45.2381
20/03/2023 10:46,2022,1,WESTERN EUROPE-EU,GERMANY,2,BIGGIN HILL,MUNSTER-OSNABRUCK,0,0,0,7,0,7,-100
20/03/2023 10:46,2022,1,WESTERN EUROPE-EU,GERMANY,2,BIGGIN HILL,NIEDERRHEIN,1,0,1,0,0,0,0
20/03/2023 10:46,2022,1,WESTERN EUROPE-EU,GERMANY,2,BIGGIN HILL,SAARBRUCKEN,2,0,2,0,0,0,0
20/03/2023 10:46,2022,1,WESTERN EUROPE-EU,GERMANY,2,BIGGIN HILL,STUTTGART,5,0,5,0,0,0,0
20/03/2023 10:46,2022,1,WESTERN EUROPE-EU,GERMANY,2,BIRMINGHAM,BERLIN BRANDENBURG,2295,2191,104,931,931,0,146.50913
20/03/2023 10:46,2022,1,WESTERN EUROPE-EU,GERMANY,2,BIRMINGHAM,DUSSELDORF,86244,86164,80,14906,14875,31,478.5858
20/03/2023 10:46,2022,1,WESTERN EUROPE-EU,GERMANY,2,BIRMINGHAM,FRANKFURT MAIN,196805,196805,0,51589,51589,0,281.48636
20/03/2023 10:46,2022,1,WESTERN EUROPE-EU,GERMANY,2,BIRMINGHAM,HANOVER,4,4,0,0,0,0,0
20/03/2023 10:46,2022,1,WESTERN EUROPE-EU,GERMANY,2,BIRMINGHAM,MUNICH,144304,144042,262,14362,14362,0,904.76257
20/03/2023 10:46,2022,1,WESTERN EUROPE-EU,GERMANY,2,BOURNEMOUTH,FRANKFURT MAIN,179,179,0,0,0,0,0
20/03/2023 10:46,2022,1,WESTERN EUROPE-EU,GERMANY,2,BRISTOL,BERLIN BRANDENBURG,46658,46658,0,7887,7887,0,491.58108
20/03/2023 10:46,2022,1,WESTERN EUROPE-EU,GERMANY,2,BRISTOL,COLOGNE BONN,42086,42086,0,2905,2905,0,1348.74355
20/03/2023 10:46,2022,1,WESTERN EUROPE-EU,GERMANY,2,BRISTOL,FRANKFURT MAIN,44974,44974,0,13274,13274,0,238.81272
20/03/2023 10:46,2022,1,WESTERN EUROPE-EU,GERMANY,2,BRISTOL,MUNICH,170,170,0,0,0,0,0
20/03/2023 10:46,2022,1,WESTERN EUROPE-EU,GERMANY,2,BRISTOL,NIEDERRHEIN,111,111,0,0,0,0,0
20/03/2023 10:46,2022,1,WESTERN EUROPE-EU,GERMANY,2,CARDIFF WALES,KARLSRUHE/BADEN BADEN,0,0,0,36,0,36,-100
20/03/2023 10:46,2022,1,WESTERN EUROPE-EU,GERMANY,2,DONCASTER SHEFFIELD,BRAUNSCHWEIG,45,0,45,0,0,0,0
20/03/2023 10:46,2022,1,WESTERN EUROPE-EU,GERMANY,2,DONCASTER SHEFFIELD,COLOGNE BONN,19,0,19,0,0,0,0
20/03/2023 10:46,2022,1,WESTERN EUROPE-EU,GERMANY,2,DONCASTER SHEFFIELD,DUSSELDORF,86,0,86,0,0,0,0
20/03/2023 10:46,2022,1,WESTERN EUROPE-EU,GERMANY,2,DONCASTER SHEFFIELD,FRANKFURT MAIN,41,0,41,0,0,0,0
20/03/2023 10:46,2022,1,WESTERN EUROPE-EU,GERMANY,2,DONCASTER SHEFFIELD,HAMBURG,235,235,0,0,0,0,0
20/03/2023 10:46,2022,1,WESTERN EUROPE-EU,GERMANY,2,DONCASTER SHEFFIELD,NUREMBERG,189,0,189,0,0,0,0
20/03/2023 10:46,2022,1,WESTERN EUROPE-EU,GERMANY,2,EAST MIDLANDS INTERNATIONAL,BERLIN BRANDENBURG,26082,26082,0,9693,9693,0,169.08078
20/03/2023 10:46,2022,1,WESTERN EUROPE-EU,GERMANY,2,EAST MIDLANDS INTERNATIONAL,COLOGNE BONN,1,1,0,0,0,0,0
20/03/2023 10:46,2022,1,WESTERN EUROPE-EU,GERMANY,2,EAST MIDLANDS INTERNATIONAL,FRANKFURT MAIN,244,244,0,0,0,0,0
20/03/2023 10:46,2022,1,WESTERN EUROPE-EU,GERMANY,2,EAST MIDLANDS INTERNATIONAL,MUNICH,101,101,0,0,0,0,0
20/03/2023 10:46,2022,1,WESTERN EUROPE-EU,GERMANY,2,EDINBURGH,BERLIN BRANDENBURG,166917,166917,0,25432,25432,0,556.32668
20/03/2023 10:46,2022,1,WESTERN EUROPE-EU,GERMANY,2,EDINBURGH,COLOGNE BONN,31913,31913,0,0,0,0,0
20/03/2023 10:46,2022,1,WESTERN EUROPE-EU,GERMANY,2,EDINBURGH,DUSSELDORF,30793,30793,0,6303,5964,339,388.54514
20/03/2023 10:46,2022,1,WESTERN EUROPE-EU,GERMANY,2,EDINBURGH,FRANKFURT MAIN,192170,192170,0,41850,41327,523,359.18757
20/03/2023 10:46,2022,1,WESTERN EUROPE-EU,GERMANY,2,EDINBURGH,HAMBURG,40016,40016,0,10076,10076,0,297.14172
20/03/2023 10:46,2022,1,WESTERN EUROPE-EU,GERMANY,2,EDINBURGH,MUNICH,52957,52957,0,757,757,0,6895.64069
20/03/2023 10:46,2022,1,WESTERN EUROPE-EU,GERMANY,2,EDINBURGH,NIEDERRHEIN,45173,45173,0,0,0,0,0
20/03/2023 10:46,2022,1,WESTERN EUROPE-EU,GERMANY,2,EXETER,ERFURT,79,0,79,0,0,0,0
20/03/2023 10:46,2022,1,WESTERN EUROPE-EU,GERMANY,2,GLASGOW,BERLIN BRANDENBURG,38209,38209,0,0,0,0,0
20/03/2023 10:46,2022,1,WESTERN EUROPE-EU,GERMANY,2,GLASGOW,COLOGNE BONN,361,0,361,294,0,294,22.78912
20/03/2023 10:46,2022,1,WESTERN EUROPE-EU,GERMANY,2,GLASGOW,DORTMUND,122,0,122,0,0,0,0
20/03/2023 10:46,2022,1,WESTERN EUROPE-EU,GERMANY,2,GLASGOW,DUSSELDORF,64,0,64,0,0,0,0
20/03/2023 10:46,2022,1,WESTERN EUROPE-EU,GERMANY,2,GLASGOW,ERFURT,1127,0,1127,0,0,0,0
20/03/2023 10:46,2022,1,WESTERN EUROPE-EU,GERMANY,2,GLASGOW,FRANKFURT MAIN,115212,114993,219,20436,20436,0,463.76982
20/03/2023 10:46,2022,1,WESTERN EUROPE-EU,GERMANY,2,GLASGOW,HAMBURG,158,0,158,0,0,0,0
20/03/2023 10:46,2022,1,WESTERN EUROPE-EU,GERMANY,2,GLASGOW,LEIPZIG,3055,0,3055,0,0,0,0
20/03/2023 10:46,2022,1,WESTERN EUROPE-EU,GERMANY,2,GLASGOW,MUNICH,14,0,14,0,0,0,0
20/03/2023 10:46,2022,1,WESTERN EUROPE-EU,GERMANY,2,GLASGOW,MUNSTER-OSNABRUCK,542,0,542,0,0,0,0
20/03/2023 10:46,2022,1,WESTERN EUROPE-EU,GERMANY,2,GLASGOW,PADERBORN,66,0,66,0,0,0,0
20/03/2023 10:46,2022,1,WESTERN EUROPE-EU,GERMANY,2,GUERNSEY,BERLIN BRANDENBURG,110,110,0,0,0,0,0
20/03/2023 10:46,2022,1,WESTERN EUROPE-EU,GERMANY,2,GUERNSEY,BRAUNSCHWEIG,34,34,0,0,0,0,0
20/03/2023 10:46,2022,1,WESTERN EUROPE-EU,GERMANY,2,GUERNSEY,BREMEN,8,8,0,0,0,0,0
20/03/2023 10:46,2022,1,WESTERN EUROPE-EU,GERMANY,2,GUERNSEY,COLOGNE BONN,22,22,0,0,0,0,0
20/03/2023 10:46,2022,1,WESTERN EUROPE-EU,GERMANY,2,GUERNSEY,DORTMUND,32,32,0,0,0,0,0
20/03/2023 10:46,2022,1,WESTERN EUROPE-EU,GERMANY,2,GUERNSEY,DUSSELDORF,14,14,0,0,0,0,0
20/03/2023 10:46,2022,1,WESTERN EUROPE-EU,GERMANY,2,GUERNSEY,FRANKFURT MAIN,58,58,0,0,0,0,0
20/03/2023 10:46,2022,1,WESTERN EUROPE-EU,GERMANY,2,GUERNSEY,HAMBURG,4,4,0,0,0,0,0
20/03/2023 10:46,2022,1,WESTERN EUROPE-EU,GERMANY,2,GUERNSEY,HANOVER,96,96,0,0,0,0,0
20/03/2023 10:46,2022,1,WESTERN EUROPE-EU,GERMANY,2,GUERNSEY,KASSEL,46,46,0,0,0,0,0
20/03/2023 10:46,2022,1,WESTERN EUROPE-EU,GERMANY,2,GUERNSEY,LEIPZIG,45,45,0,0,0,0,0
20/03/2023 10:46,2022,1,WESTERN EUROPE-EU,GERMANY,2,GUERNSEY,LUBECK,11,11,0,0,0,0,0
20/03/2023 10:46,2022,1,WESTERN EUROPE-EU,GERMANY,2,GUERNSEY,MEMMINGEN ALLGAU,71,71,0,0,0,0,0
20/03/2023 10:46,2022,1,WESTERN EUROPE-EU,GERMANY,2,GUERNSEY,MUNICH,20,20,0,0,0,0,0
20/03/2023 10:46,2022,1,WESTERN EUROPE-EU,GERMANY,2,GUERNSEY,MUNSTER-OSNABRUCK,67,49,18,0,0,0,0
20/03/2023 10:46,2022,1,WESTERN EUROPE-EU,GERMANY,2,GUERNSEY,NUREMBERG,14,14,0,0,0,0,0
20/03/2023 10:46,2022,1,WESTERN EUROPE-EU,GERMANY,2,GUERNSEY,STUTTGART,149,84,65,0,0,0,0
20/03/2023 10:46,2022,1,WESTERN EUROPE-EU,GERMANY,2,JERSEY,BERLIN BRANDENBURG,208,0,208,0,0,0,0
20/03/2023 10:46,2022,1,WESTERN EUROPE-EU,GERMANY,2,JERSEY,BREMEN,130,0,130,0,0,0,0
20/03/2023 10:46,2022,1,WESTERN EUROPE-EU,GERMANY,2,JERSEY,COLOGNE BONN,98,0,98,0,0,0,0
20/03/2023 10:46,2022,1,WESTERN EUROPE-EU,GERMANY,2,JERSEY,DORTMUND,49,0,49,0,0,0,0
20/03/2023 10:46,2022,1,WESTERN EUROPE-EU,GERMANY,2,JERSEY,DRESDEN,113,0,113,0,0,0,0
20/03/2023 10:46,2022,1,WESTERN EUROPE-EU,GERMANY,2,JERSEY,DUSSELDORF,2553,1687,866,0,0,0,0
20/03/2023 10:46,2022,1,WESTERN EUROPE-EU,GERMANY,2,JERSEY,FRANKFURT MAIN,144,0,144,0,0,0,0
20/03/2023 10:46,2022,1,WESTERN EUROPE-EU,GERMANY,2,JERSEY,HAMBURG,84,0,84,0,0,0,0
20/03/2023 10:46,2022,1,WESTERN EUROPE-EU,GERMANY,2,JERSEY,HANOVER,132,0,132,0,0,0,0
20/03/2023 10:46,2022,1,WESTERN EUROPE-EU,GERMANY,2,JERSEY,KASSEL,24,0,24,0,0,0,0
20/03/2023 10:46,2022,1,WESTERN EUROPE-EU,GERMANY,2,JERSEY,LEIPZIG,156,0,156,0,0,0,0
20/03/2023 10:46,2022,1,WESTERN EUROPE-EU,GERMANY,2,JERSEY,LUBECK,497,451,46,0,0,0,0
20/03/2023 10:46,2022,1,WESTERN EUROPE-EU,GERMANY,2,JERSEY,MEMMINGEN ALLGAU,188,0,188,0,0,0,0
20/03/2023 10:46,2022,1,WESTERN EUROPE-EU,GERMANY,2,JERSEY,MUNICH,3418,3368,50,0,0,0,0
20/03/2023 10:46,2022,1,WESTERN EUROPE-EU,GERMANY,2,JERSEY,MUNSTER-OSNABRUCK,266,0,266,0,0,0,0
20/03/2023 10:46,2022,1,WESTERN EUROPE-EU,GERMANY,2,JERSEY,NUREMBERG,215,0,215,0,0,0,0
20/03/2023 10:46,2022,1,WESTERN EUROPE-EU,GERMANY,2,JERSEY,ROSTOCK-LAAGE,291,0,291,0,0,0,0
20/03/2023 10:46,2022,1,WESTERN EUROPE-EU,GERMANY,2,JERSEY,STUTTGART,135,0,135,0,0,0,0
20/03/2023 10:46,2022,1,WESTERN EUROPE-EU,GERMANY,2,KIRKWALL,SIEGERLANDS,6,6,0,0,0,0,0
20/03/2023 10:46,2022,1,WESTERN EUROPE-EU,GERMANY,2,LEEDS BRADFORD,BERLIN BRANDENBURG,1408,1408,0,672,672,0,109.52381
20/03/2023 10:46,2022,1,WESTERN EUROPE-EU,GERMANY,2,LEEDS BRADFORD,COLOGNE BONN,878,428,450,338,338,0,159.76331
20/03/2023 10:46,2022,1,WESTERN EUROPE-EU,GERMANY,2,LIVERPOOL (JOHN LENNON),DORTMUND,129,0,129,0,0,0,0
20/03/2023 10:46,2022,1,WESTERN EUROPE-EU,GERMANY,2,LIVERPOOL (JOHN LENNON),FRANKFURT MAIN,13233,13233,0,0,0,0,0
20/03/2023 10:46,2022,1,WESTERN EUROPE-EU,GERMANY,2,LIVERPOOL (JOHN LENNON),LEIPZIG,69,0,69,0,0,0,0
20/03/2023 10:46,2022,1,WESTERN EUROPE-EU,GERMANY,2,LIVERPOOL (JOHN LENNON),MUNICH,61,0,61,0,0,0,0
20/03/2023 10:46,2022,1,WESTERN EUROPE-EU,GERMANY,2,MANCHESTER,BERLIN BRANDENBURG,177823,177823,0,46972,46972,0,278.57234
20/03/2023 10:46,2022,1,WESTERN EUROPE-EU,GERMANY,2,MANCHESTER,COLOGNE BONN,70475,70475,0,18071,18071,0,289.98949
20/03/2023 10:46,2022,1,WESTERN EUROPE-EU,GERMANY,2,MANCHESTER,DORTMUND,425,0,425,202,0,202,110.39604
20/03/2023 10:46,2022,1,WESTERN EUROPE-EU,GERMANY,2,MANCHESTER,DUSSELDORF,83409,83409,0,19326,19326,0,331.58957
20/03/2023 10:46,2022,1,WESTERN EUROPE-EU,GERMANY,2,MANCHESTER,EGELSBACH,0,0,0,40,40,0,-100
20/03/2023 10:46,2022,1,WESTERN EUROPE-EU,GERMANY,2,MANCHESTER,FRANKFURT MAIN,315695,315413,282,98600,98600,0,220.17748
20/03/2023 10:46,2022,1,WESTERN EUROPE-EU,GERMANY,2,MANCHESTER,HAMBURG,43959,43959,0,8674,8674,0,406.79041
20/03/2023 10:46,2022,1,WESTERN EUROPE-EU,GERMANY,2,MANCHESTER,HANOVER,84,0,84,0,0,0,0
20/03/2023 10:46,2022,1,WESTERN EUROPE-EU,GERMANY,2,MANCHESTER,LEIPZIG,0,0,0,362,0,362,-100
20/03/2023 10:46,2022,1,WESTERN EUROPE-EU,GERMANY,2,MANCHESTER,MUNICH,269883,269488,395,44117,44117,0,511.74377
20/03/2023 10:46,2022,1,WESTERN EUROPE-EU,GERMANY,2,MANCHESTER,MUNSTER-OSNABRUCK,369,0,369,0,0,0,0
20/03/2023 10:46,2022,1,WESTERN EUROPE-EU,GERMANY,2,MANCHESTER,PADERBORN,0,0,0,63,0,63,-100
20/03/2023 10:46,2022,1,WESTERN EUROPE-EU,GERMANY,2,MANCHESTER,STUTTGART,0,0,0,4,0,4,-100
20/03/2023 10:46,2022,1,WESTERN EUROPE-EU,GERMANY,2,NEWCASTLE,BERLIN BRANDENBURG,1738,1738,0,827,827,0,110.15719
20/03/2023 10:46,2022,1,WESTERN EUROPE-EU,GERMANY,2,NEWCASTLE,COLOGNE BONN,632,632,0,141,141,0,348.22695
20/03/2023 10:46,2022,1,WESTERN EUROPE-EU,GERMANY,2,NEWCASTLE,DUSSELDORF,18917,18917,0,2255,2255,0,738.89135
20/03/2023 10:46,2022,1,WESTERN EUROPE-EU,GERMANY,2,NEWCASTLE,FRANKFURT MAIN,37673,37673,0,10040,10040,0,275.22908
20/03/2023 10:46,2022,1,WESTERN EUROPE-EU,GERMANY,2,NEWQUAY,DUSSELDORF,3412,3412,0,0,0,0,0
20/03/2023 10:46,2022,1,WESTERN EUROPE-EU,GERMANY,2,PRESTWICK,HAMBURG,146,0,146,0,0,0,0
20/03/2023 10:46,2022,1,WESTERN EUROPE-EU,GERMANY,2,PRESTWICK,MUNICH,37,0,37,0,0,0,0
20/03/2023 10:46,2022,1,WESTERN EUROPE-EU,GERMANY,2,PRESTWICK,OBERPFAFFENHOFEN,41,0,41,0,0,0,0
20/03/2023 10:46,2022,1,WESTERN EUROPE-EU,GERMANY,2,SOUTHAMPTON,BERLIN BRANDENBURG,0,0,0,867,867,0,-100
20/03/2023 10:46,2022,1,WESTERN EUROPE-EU,GIBRALTAR,1,GATWICK,GIBRALTAR,153043,153043,0,73207,73207,0,109.05514
20/03/2023 10:46,2022,1,WESTERN EUROPE-EU,GIBRALTAR,1,HEATHROW,GIBRALTAR,152468,152366,102,102770,102770,0,48.35847
20/03/2023 10:46,2022,1,WESTERN EUROPE-EU,GIBRALTAR,1,LONDON CITY,GIBRALTAR,0,0,0,3078,3078,0,-100
20/03/2023 10:46,2022,1,WESTERN EUROPE-EU,GIBRALTAR,1,LUTON,GIBRALTAR,388,388,0,11255,11255,0,-96.55264
20/03/2023 10:46,2022,1,WESTERN EUROPE-EU,GIBRALTAR,1,STANSTED,GIBRALTAR,0,0,0,149,0,149,-100
20/03/2023 10:46,2022,1,WESTERN EUROPE-EU,GIBRALTAR,2,ABERDEEN,GIBRALTAR,0,0,0,76,0,76,-100
20/03/2023 10:46,2022,1,WESTERN EUROPE-EU,GIBRALTAR,2,BIGGIN HILL,GIBRALTAR,0,0,0,28,0,28,-100
20/03/2023 10:46,2022,1,WESTERN EUROPE-EU,GIBRALTAR,2,BIRMINGHAM,GIBRALTAR,0,0,0,2420,2420,0,-100
20/03/2023 10:46,2022,1,WESTERN EUROPE-EU,GIBRALTAR,2,BRISTOL,GIBRALTAR,37133,37133,0,18827,18827,0,97.2327
20/03/2023 10:46,2022,1,WESTERN EUROPE-EU,GIBRALTAR,2,EAST MIDLANDS INTERNATIONAL,GIBRALTAR,65,0,65,0,0,0,0
20/03/2023 10:46,2022,1,WESTERN EUROPE-EU,GIBRALTAR,2,EDINBURGH,GIBRALTAR,16274,16274,0,8538,8538,0,90.6067
20/03/2023 10:46,2022,1,WESTERN EUROPE-EU,GIBRALTAR,2,MANCHESTER,GIBRALTAR,85370,85370,0,38516,38516,0,121.64815
20/03/2023 10:46,2022,1,WESTERN EUROPE-EU,GIBRALTAR,2,SOUTHAMPTON,GIBRALTAR,0,0,0,1845,1845,0,-100
20/03/2023 10:46,2022,1,WESTERN EUROPE-EU,GREECE,1,GATWICK,ATHENS,316229,316229,0,54955,54955,0,475.43263
20/03/2023 10:46,2022,1,WESTERN EUROPE-EU,GREECE,1,GATWICK,CHANIA,193660,165003,28657,35984,28476,7508,438.18364
20/03/2023 10:46,2022,1,WESTERN EUROPE-EU,GREECE,1,GATWICK,CORFU,249881,207822,42059,63193,48751,14442,295.42513
20/03/2023 10:46,2022,1,WESTERN EUROPE-EU,GREECE,1,GATWICK,HERAKLION,232851,182825,50026,61598,39804,21794,278.01714
20/03/2023 10:46,2022,1,WESTERN EUROPE-EU,GREECE,1,GATWICK,KALAMATA,48829,40328,8501,13061,8789,4272,273.85346
20/03/2023 10:46,2022,1,WESTERN EUROPE-EU,GREECE,1,GATWICK,KAVALA,13082,0,13082,1591,0,1591,722.25016
20/03/2023 10:46,2022,1,WESTERN EUROPE-EU,GREECE,1,GATWICK,KEFALLINIA,132296,106282,26014,31098,26787,4311,325.41643
20/03/2023 10:46,2022,1,WESTERN EUROPE-EU,GREECE,1,GATWICK,KOS,127065,72292,54773,37017,11469,25548,243.2612
20/03/2023 10:46,2022,1,WESTERN EUROPE-EU,GREECE,1,GATWICK,LEMNOS,6168,6168,0,1908,0,1908,223.27044
20/03/2023 10:46,2022,1,WESTERN EUROPE-EU,GREECE,1,GATWICK,MIKONOS,103614,103614,0,23721,23721,0,336.80283
20/03/2023 10:46,2022,1,WESTERN EUROPE-EU,GREECE,1,GATWICK,NEA ANCHIALOS,14820,14820,0,3104,3104,0,377.44845
20/03/2023 10:46,2022,1,WESTERN EUROPE-EU,GREECE,1,GATWICK,PREVEZA,109124,87147,21977,27770,18630,9140,292.95643
20/03/2023 10:46,2022,1,WESTERN EUROPE-EU,GREECE,1,GATWICK,RHODES,246034,187306,58728,67837,37939,29898,262.68408
20/03/2023 10:46,2022,1,WESTERN EUROPE-EU,GREECE,1,GATWICK,SALONIKA,162847,146860,15987,29939,27427,2512,443.92932
20/03/2023 10:46,2022,1,WESTERN EUROPE-EU,GREECE,1,GATWICK,SAMOS,6850,0,6850,1452,0,1452,371.76309
20/03/2023 10:46,2022,1,WESTERN EUROPE-EU,GREECE,1,GATWICK,SKIATHOS,24549,3708,20841,7736,0,7736,217.33454
20/03/2023 10:46,2022,1,WESTERN EUROPE-EU,GREECE,1,GATWICK,THIRA (SANTORINI),136031,136031,0,25739,23524,2215,428.5015
20/03/2023 10:46,2022,1,WESTERN EUROPE-EU,GREECE,1,GATWICK,ZAKINTHOS,130194,90753,39441,34065,19957,14108,282.19287
20/03/2023 10:46,2022,1,WESTERN EUROPE-EU,GREECE,1,HEATHROW,ATHENS,764419,764419,0,369812,369717,95,106.70476
20/03/2023 10:46,2022,1,WESTERN EUROPE-EU,GREECE,1,HEATHROW,CHANIA,38450,38450,0,28938,28938,0,32.87027
20/03/2023 10:46,2022,1,WESTERN EUROPE-EU,GREECE,1,HEATHROW,CORFU,104037,104037,0,66134,66134,0,57.31243
20/03/2023 10:46,2022,1,WESTERN EUROPE-EU,GREECE,1,HEATHROW,HERAKLION,51287,51287,0,36239,36239,0,41.52432
20/03/2023 10:46,2022,1,WESTERN EUROPE-EU,GREECE,1,HEATHROW,KALAMATA,15055,15055,0,14715,14715,0,2.31057
20/03/2023 10:46,2022,1,WESTERN EUROPE-EU,GREECE,1,HEATHROW,KEFALLINIA,14670,14670,0,12855,12855,0,14.11902
20/03/2023 10:46,2022,1,WESTERN EUROPE-EU,GREECE,1,HEATHROW,KOS,15690,15690,0,17827,17827,0,-11.98743
20/03/2023 10:46,2022,1,WESTERN EUROPE-EU,GREECE,1,HEATHROW,MIKONOS,55496,55496,0,43499,43499,0,27.57994
20/03/2023 10:46,2022,1,WESTERN EUROPE-EU,GREECE,1,HEATHROW,PREVEZA,21802,21802,0,21061,18413,2648,3.51835
20/03/2023 10:46,2022,1,WESTERN EUROPE-EU,GREECE,1,HEATHROW,RHODES,24519,24519,0,22834,22834,0,7.37935
20/03/2023 10:46,2022,1,WESTERN EUROPE-EU,GREECE,1,HEATHROW,SALONIKA,47029,47029,0,48107,48107,0,-2.24084
20/03/2023 10:46,2022,1,WESTERN EUROPE-EU,GREECE,1,HEATHROW,THIRA (SANTORINI),65011,65011,0,40531,40531,0,60.39821
20/03/2023 10:46,2022,1,WESTERN EUROPE-EU,GREECE,1,HEATHROW,ZAKINTHOS,9637,9637,0,7387,7387,0,30.45891
20/03/2023 10:46,2022,1,WESTERN EUROPE-EU,GREECE,1,LONDON CITY,MIKONOS,15791,15791,0,9047,9047,0,74.54405
20/03/2023 10:46,2022,1,WESTERN EUROPE-EU,GREECE,1,LONDON CITY,SALONIKA,1506,1506,0,0,0,0,0
20/03/2023 10:46,2022,1,WESTERN EUROPE-EU,GREECE,1,LONDON CITY,SKIATHOS,5662,5662,0,3844,3844,0,47.29448
20/03/2023 10:46,2022,1,WESTERN EUROPE-EU,GREECE,1,LONDON CITY,THIRA (SANTORINI),2848,2848,0,0,0,0,0
20/03/2023 10:46,2022,1,WESTERN EUROPE-EU,GREECE,1,LUTON,ATHENS,86209,86209,0,61182,61182,0,40.90582
20/03/2023 10:46,2022,1,WESTERN EUROPE-EU,GREECE,1,LUTON,CHANIA,14841,14841,0,0,0,0,0
20/03/2023 10:46,2022,1,WESTERN EUROPE-EU,GREECE,1,LUTON,CORFU,87273,72750,14523,21790,21790,0,300.51859
20/03/2023 10:46,2022,1,WESTERN EUROPE-EU,GREECE,1,LUTON,HERAKLION,40315,40315,0,18926,18926,0,113.01384
20/03/2023 10:46,2022,1,WESTERN EUROPE-EU,GREECE,1,LUTON,KALAMATA,204,0,204,0,0,0,0
20/03/2023 10:46,2022,1,WESTERN EUROPE-EU,GREECE,1,LUTON,KEFALLINIA,4931,4931,0,0,0,0,0
20/03/2023 10:46,2022,1,WESTERN EUROPE-EU,GREECE,1,LUTON,KOS,7266,0,7266,0,0,0,0
20/03/2023 10:46,2022,1,WESTERN EUROPE-EU,GREECE,1,LUTON,MIKONOS,16644,16644,0,5871,5871,0,183.49515
20/03/2023 10:46,2022,1,WESTERN EUROPE-EU,GREECE,1,LUTON,PREVEZA,2169,2169,0,0,0,0,0
20/03/2023 10:46,2022,1,WESTERN EUROPE-EU,GREECE,1,LUTON,RHODES,57224,39312,17912,17734,10283,7451,222.6796
20/03/2023 10:46,2022,1,WESTERN EUROPE-EU,GREECE,1,LUTON,SALONIKA,61306,61306,0,15356,15356,0,299.23157
20/03/2023 10:46,2022,1,WESTERN EUROPE-EU,GREECE,1,LUTON,SKIATHOS,5598,173,5425,0,0,0,0
20/03/2023 10:46,2022,1,WESTERN EUROPE-EU,GREECE,1,LUTON,THIRA (SANTORINI),26115,26115,0,7627,7627,0,242.40199
20/03/2023 10:46,2022,1,WESTERN EUROPE-EU,GREECE,1,LUTON,ZAKINTHOS,27859,27859,0,10282,10282,0,170.94923
20/03/2023 10:46,2022,1,WESTERN EUROPE-EU,GREECE,1,SOUTHEND,ATHENS,143,143,0,0,0,0,0
20/03/2023 10:46,2022,1,WESTERN EUROPE-EU,GREECE,1,SOUTHEND,CORFU,0,0,0,11009,11009,0,-100
20/03/2023 10:46,2022,1,WESTERN EUROPE-EU,GREECE,1,SOUTHEND,KAVALA,0,0,0,42,42,0,-100
20/03/2023 10:46,2022,1,WESTERN EUROPE-EU,GREECE,1,STANSTED,ATHENS,126138,126138,0,70981,70981,0,77.70671
20/03/2023 10:46,2022,1,WESTERN EUROPE-EU,GREECE,1,STANSTED,CHANIA,62603,62603,0,28056,28056,0,123.13587
20/03/2023 10:46,2022,1,WESTERN EUROPE-EU,GREECE,1,STANSTED,CORFU,87318,72863,14455,23513,23513,0,271.36052
20/03/2023 10:46,2022,1,WESTERN EUROPE-EU,GREECE,1,STANSTED,HERAKLION,87538,72619,14919,22732,16584,6148,285.0871
20/03/2023 10:46,2022,1,WESTERN EUROPE-EU,GREECE,1,STANSTED,KALAMATA,16697,16316,381,3464,3464,0,382.01501
20/03/2023 10:46,2022,1,WESTERN EUROPE-EU,GREECE,1,STANSTED,KEFALLINIA,59574,46129,13445,15974,13604,2370,272.94353
20/03/2023 10:46,2022,1,WESTERN EUROPE-EU,GREECE,1,STANSTED,KOS,37853,37853,0,10653,10653,0,255.32714
20/03/2023 10:46,2022,1,WESTERN EUROPE-EU,GREECE,1,STANSTED,MYTILINI,7310,7310,0,4053,2003,2050,80.36023
20/03/2023 10:46,2022,1,WESTERN EUROPE-EU,GREECE,1,STANSTED,PREVEZA,33428,33428,0,10142,10142,0,229.59968
20/03/2023 10:46,2022,1,WESTERN EUROPE-EU,GREECE,1,STANSTED,RHODES,144636,127041,17595,52360,43210,9150,176.23377
20/03/2023 10:46,2022,1,WESTERN EUROPE-EU,GREECE,1,STANSTED,SALONIKA,123350,123350,0,51777,51765,12,138.23319
20/03/2023 10:46,2022,1,WESTERN EUROPE-EU,GREECE,1,STANSTED,SKIATHOS,20774,20774,0,5296,5296,0,292.25831
20/03/2023 10:46,2022,1,WESTERN EUROPE-EU,GREECE,1,STANSTED,THIRA (SANTORINI),38789,38789,0,12103,12103,0,220.49079
20/03/2023 10:46,2022,1,WESTERN EUROPE-EU,GREECE,1,STANSTED,ZAKINTHOS,54146,46890,7256,19105,17359,1746,183.41272
20/03/2023 10:46,2022,1,WESTERN EUROPE-EU,GREECE,2,ABERDEEN,CORFU,8416,0,8416,0,0,0,0
20/03/2023 10:46,2022,1,WESTERN EUROPE-EU,GREECE,2,ABERDEEN,RHODES,6307,0,6307,0,0,0,0
20/03/2023 10:46,2022,1,WESTERN EUROPE-EU,GREECE,2,BELFAST CITY (GEORGE BEST),ATHENS,177,0,177,0,0,0,0
20/03/2023 10:46,2022,1,WESTERN EUROPE-EU,GREECE,2,BELFAST INTERNATIONAL,CORFU,24399,17136,7263,5329,5329,0,357.85326
20/03/2023 10:46,2022,1,WESTERN EUROPE-EU,GREECE,2,BELFAST INTERNATIONAL,HERAKLION,9020,9020,0,2628,2628,0,243.22679
20/03/2023 10:46,2022,1,WESTERN EUROPE-EU,GREECE,2,BELFAST INTERNATIONAL,KOS,7111,0,7111,0,0,0,0
20/03/2023 10:46,2022,1,WESTERN EUROPE-EU,GREECE,2,BELFAST INTERNATIONAL,NEA ANCHIALOS,44,0,44,0,0,0,0
20/03/2023 10:46,2022,1,WESTERN EUROPE-EU,GREECE,2,BELFAST INTERNATIONAL,RHODES,15902,9360,6542,1753,1753,0,807.13063
20/03/2023 10:46,2022,1,WESTERN EUROPE-EU,GREECE,2,BELFAST INTERNATIONAL,ZAKINTHOS,7862,7862,0,0,0,0,0
20/03/2023 10:46,2022,1,WESTERN EUROPE-EU,GREECE,2,BIGGIN HILL,ATHENS,48,0,48,79,0,79,-39.24051
20/03/2023 10:46,2022,1,WESTERN EUROPE-EU,GREECE,2,BIGGIN HILL,CHANIA,7,0,7,2,0,2,250
20/03/2023 10:46,2022,1,WESTERN EUROPE-EU,GREECE,2,BIGGIN HILL,CORFU,8,0,8,9,0,9,-11.11111
20/03/2023 10:46,2022,1,WESTERN EUROPE-EU,GREECE,2,BIGGIN HILL,KEFALLINIA,4,0,4,12,0,12,-66.66667
20/03/2023 10:46,2022,1,WESTERN EUROPE-EU,GREECE,2,BIGGIN HILL,RHODES,2,0,2,0,0,0,0
20/03/2023 10:46,2022,1,WESTERN EUROPE-EU,GREECE,2,BIGGIN HILL,SALONIKA,3,0,3,2,0,2,50
20/03/2023 10:46,2022,1,WESTERN EUROPE-EU,GREECE,2,BIGGIN HILL,THIRA (SANTORINI),10,0,10,0,0,0,0
20/03/2023 10:46,2022,1,WESTERN EUROPE-EU,GREECE,2,BIRMINGHAM,ATHENS,21605,21605,0,314,0,314,6780.57325
20/03/2023 10:46,2022,1,WESTERN EUROPE-EU,GREECE,2,BIRMINGHAM,CHANIA,29312,11554,17758,9110,7642,1468,221.75631
20/03/2023 10:46,2022,1,WESTERN EUROPE-EU,GREECE,2,BIRMINGHAM,CORFU,90406,55822,34584,32031,24937,7094,182.24532
20/03/2023 10:46,2022,1,WESTERN EUROPE-EU,GREECE,2,BIRMINGHAM,HERAKLION,90702,59068,31634,23912,14343,9569,279.31582
20/03/2023 10:46,2022,1,WESTERN EUROPE-EU,GREECE,2,BIRMINGHAM,KALAMATA,7248,7248,0,1661,1661,0,336.36364
20/03/2023 10:46,2022,1,WESTERN EUROPE-EU,GREECE,2,BIRMINGHAM,KAVALA,5463,0,5463,0,0,0,0
20/03/2023 10:46,2022,1,WESTERN EUROPE-EU,GREECE,2,BIRMINGHAM,KEFALLINIA,39080,19366,19714,8134,4293,3841,380.45242
20/03/2023 10:46,2022,1,WESTERN EUROPE-EU,GREECE,2,BIRMINGHAM,KOS,70733,35156,35577,17828,8535,9293,296.7523
20/03/2023 10:46,2022,1,WESTERN EUROPE-EU,GREECE,2,BIRMINGHAM,MIKONOS,0,0,0,2,0,2,-100
20/03/2023 10:46,2022,1,WESTERN EUROPE-EU,GREECE,2,BIRMINGHAM,PREVEZA,13993,13993,0,2949,2949,0,374.49983
20/03/2023 10:46,2022,1,WESTERN EUROPE-EU,GREECE,2,BIRMINGHAM,RHODES,111302,69045,42257,31923,17845,14078,248.65771
20/03/2023 10:46,2022,1,WESTERN EUROPE-EU,GREECE,2,BIRMINGHAM,SALONIKA,24841,8517,16324,3954,2168,1786,528.24987
20/03/2023 10:46,2022,1,WESTERN EUROPE-EU,GREECE,2,BIRMINGHAM,SKIATHOS,26198,13132,13066,8328,2724,5604,214.57733
20/03/2023 10:46,2022,1,WESTERN EUROPE-EU,GREECE,2,BIRMINGHAM,THIRA (SANTORINI),28533,15855,12678,5129,3621,1508,456.30727
20/03/2023 10:46,2022,1,WESTERN EUROPE-EU,GREECE,2,BIRMINGHAM,ZAKINTHOS,79271,39311,39960,22090,7289,14801,258.85469
20/03/2023 10:46,2022,1,WESTERN EUROPE-EU,GREECE,2,BOURNEMOUTH,CORFU,16719,0,16719,5900,0,5900,183.37288
20/03/2023 10:46,2022,1,WESTERN EUROPE-EU,GREECE,2,BOURNEMOUTH,HERAKLION,7670,0,7670,0,0,0,0
20/03/2023 10:46,2022,1,WESTERN EUROPE-EU,GREECE,2,BOURNEMOUTH,KEFALLINIA,7135,0,7135,0,0,0,0
20/03/2023 10:46,2022,1,WESTERN EUROPE-EU,GREECE,2,BOURNEMOUTH,RHODES,9232,186,9046,4050,0,4050,127.95062
20/03/2023 10:46,2022,1,WESTERN EUROPE-EU,GREECE,2,BOURNEMOUTH,ZAKINTHOS,6993,5,6988,0,0,0,0
20/03/2023 10:46,2022,1,WESTERN EUROPE-EU,GREECE,2,BRISTOL,ATHENS,24986,24986,0,5710,5710,0,337.58319
20/03/2023 10:46,2022,1,WESTERN EUROPE-EU,GREECE,2,BRISTOL,CHANIA,0,0,0,6314,6314,0,-100
20/03/2023 10:46,2022,1,WESTERN EUROPE-EU,GREECE,2,BRISTOL,CORFU,87732,65442,22290,20153,13334,6819,335.32973
20/03/2023 10:46,2022,1,WESTERN EUROPE-EU,GREECE,2,BRISTOL,HERAKLION,69208,42897,26311,16560,12600,3960,317.92271
20/03/2023 10:46,2022,1,WESTERN EUROPE-EU,GREECE,2,BRISTOL,KEFALLINIA,44579,30488,14091,8278,6387,1891,438.5238
20/03/2023 10:46,2022,1,WESTERN EUROPE-EU,GREECE,2,BRISTOL,KOS,69259,45624,23635,17131,8614,8517,304.29047
20/03/2023 10:46,2022,1,WESTERN EUROPE-EU,GREECE,2,BRISTOL,MIKONOS,4723,4723,0,1565,1565,0,201.78914
20/03/2023 10:46,2022,1,WESTERN EUROPE-EU,GREECE,2,BRISTOL,MYTILINI,6423,6423,0,0,0,0,0
20/03/2023 10:46,2022,1,WESTERN EUROPE-EU,GREECE,2,BRISTOL,PREVEZA,17672,17672,0,5052,5052,0,249.80206
20/03/2023 10:46,2022,1,WESTERN EUROPE-EU,GREECE,2,BRISTOL,RHODES,82369,59044,23325,12010,9895,2115,585.8368
20/03/2023 10:46,2022,1,WESTERN EUROPE-EU,GREECE,2,BRISTOL,SALONIKA,14153,6225,7928,0,0,0,0
20/03/2023 10:46,2022,1,WESTERN EUROPE-EU,GREECE,2,BRISTOL,SKIATHOS,24361,12145,12216,3360,2053,1307,625.02976
20/03/2023 10:46,2022,1,WESTERN EUROPE-EU,GREECE,2,BRISTOL,THIRA (SANTORINI),21993,16450,5543,2488,2488,0,783.96302
20/03/2023 10:46,2022,1,WESTERN EUROPE-EU,GREECE,2,BRISTOL,ZAKINTHOS,70593,39861,30732,13744,8357,5387,413.62776
20/03/2023 10:46,2022,1,WESTERN EUROPE-EU,GREECE,2,CARDIFF WALES,CORFU,24779,9154,15625,1386,0,1386,1687.80664
20/03/2023 10:46,2022,1,WESTERN EUROPE-EU,GREECE,2,CARDIFF WALES,HERAKLION,15528,8465,7063,0,0,0,0
20/03/2023 10:46,2022,1,WESTERN EUROPE-EU,GREECE,2,CARDIFF WALES,KEFALLINIA,6717,0,6717,0,0,0,0
20/03/2023 10:46,2022,1,WESTERN EUROPE-EU,GREECE,2,CARDIFF WALES,KOS,15519,0,15519,1164,0,1164,1233.24742
20/03/2023 10:46,2022,1,WESTERN EUROPE-EU,GREECE,2,CARDIFF WALES,NEA ANCHIALOS,106,0,106,0,0,0,0
20/03/2023 10:46,2022,1,WESTERN EUROPE-EU,GREECE,2,CARDIFF WALES,PATRAS,0,0,0,24,0,24,-100
20/03/2023 10:46,2022,1,WESTERN EUROPE-EU,GREECE,2,CARDIFF WALES,RHODES,17551,0,17551,6826,0,6826,157.11984
20/03/2023 10:46,2022,1,WESTERN EUROPE-EU,GREECE,2,CARDIFF WALES,ZAKINTHOS,13446,0,13446,0,0,0,0
20/03/2023 10:46,2022,1,WESTERN EUROPE-EU,GREECE,2,DONCASTER SHEFFIELD,ATHENS,9,0,9,0,0,0,0
20/03/2023 10:46,2022,1,WESTERN EUROPE-EU,GREECE,2,DONCASTER SHEFFIELD,CHANIA,3546,182,3364,0,0,0,0
20/03/2023 10:46,2022,1,WESTERN EUROPE-EU,GREECE,2,DONCASTER SHEFFIELD,CORFU,21549,0,21549,6083,0,6083,254.24955
20/03/2023 10:46,2022,1,WESTERN EUROPE-EU,GREECE,2,DONCASTER SHEFFIELD,HERAKLION,13545,0,13545,2526,0,2526,436.22328
20/03/2023 10:46,2022,1,WESTERN EUROPE-EU,GREECE,2,DONCASTER SHEFFIELD,KEFALLINIA,14817,0,14817,0,0,0,0
20/03/2023 10:46,2022,1,WESTERN EUROPE-EU,GREECE,2,DONCASTER SHEFFIELD,KOS,15337,0,15337,0,0,0,0
20/03/2023 10:46,2022,1,WESTERN EUROPE-EU,GREECE,2,DONCASTER SHEFFIELD,PREVEZA,0,0,0,7,0,7,-100
20/03/2023 10:46,2022,1,WESTERN EUROPE-EU,GREECE,2,DONCASTER SHEFFIELD,RHODES,24398,0,24398,8380,0,8380,191.14558
20/03/2023 10:46,2022,1,WESTERN EUROPE-EU,GREECE,2,DONCASTER SHEFFIELD,SALONIKA,8,0,8,0,0,0,0
20/03/2023 10:46,2022,1,WESTERN EUROPE-EU,GREECE,2,DONCASTER SHEFFIELD,SKIATHOS,12,0,12,6,0,6,100
20/03/2023 10:46,2022,1,WESTERN EUROPE-EU,GREECE,2,DONCASTER SHEFFIELD,ZAKINTHOS,24118,0,24118,4888,0,4888,393.41244
20/03/2023 10:46,2022,1,WESTERN EUROPE-EU,GREECE,2,EAST MIDLANDS INTERNATIONAL,ATHENS,109,0,109,0,0,0,0
20/03/2023 10:46,2022,1,WESTERN EUROPE-EU,GREECE,2,EAST MIDLANDS INTERNATIONAL,CHANIA,19823,19823,0,3730,3730,0,431.44772
20/03/2023 10:46,2022,1,WESTERN EUROPE-EU,GREECE,2,EAST MIDLANDS INTERNATIONAL,CORFU,53616,36796,16820,12762,12762,0,320.12224
20/03/2023 10:46,2022,1,WESTERN EUROPE-EU,GREECE,2,EAST MIDLANDS INTERNATIONAL,HERAKLION,34642,18493,16149,10961,5311,5650,216.04781
20/03/2023 10:46,2022,1,WESTERN EUROPE-EU,GREECE,2,EAST MIDLANDS INTERNATIONAL,KEFALLINIA,13186,7199,5987,1128,1128,0,1068.97163
20/03/2023 10:46,2022,1,WESTERN EUROPE-EU,GREECE,2,EAST MIDLANDS INTERNATIONAL,KOS,34364,8992,25372,11406,2925,8481,201.28003
20/03/2023 10:46,2022,1,WESTERN EUROPE-EU,GREECE,2,EAST MIDLANDS INTERNATIONAL,RHODES,59210,37361,21849,20966,12836,8130,182.40962
20/03/2023 10:46,2022,1,WESTERN EUROPE-EU,GREECE,2,EAST MIDLANDS INTERNATIONAL,SKIATHOS,13029,6586,6443,2311,1166,1145,463.78191
20/03/2023 10:46,2022,1,WESTERN EUROPE-EU,GREECE,2,EAST MIDLANDS INTERNATIONAL,THIRA (SANTORINI),6649,0,6649,0,0,0,0
20/03/2023 10:46,2022,1,WESTERN EUROPE-EU,GREECE,2,EAST MIDLANDS INTERNATIONAL,ZAKINTHOS,47025,22329,24696,9262,5320,3942,407.71971
20/03/2023 10:46,2022,1,WESTERN EUROPE-EU,GREECE,2,EDINBURGH,ATHENS,48957,48957,0,15457,15457,0,216.73028
20/03/2023 10:46,2022,1,WESTERN EUROPE-EU,GREECE,2,EDINBURGH,CORFU,44214,35721,8493,8642,8642,0,411.61768
20/03/2023 10:46,2022,1,WESTERN EUROPE-EU,GREECE,2,EDINBURGH,HERAKLION,37266,37266,0,9658,9658,0,285.85628
20/03/2023 10:46,2022,1,WESTERN EUROPE-EU,GREECE,2,EDINBURGH,KEFALLINIA,4586,4586,0,0,0,0,0
20/03/2023 10:46,2022,1,WESTERN EUROPE-EU,GREECE,2,EDINBURGH,KOS,8392,8392,0,807,807,0,939.90087
20/03/2023 10:46,2022,1,WESTERN EUROPE-EU,GREECE,2,EDINBURGH,PREVEZA,7263,7263,0,0,0,0,0
20/03/2023 10:46,2022,1,WESTERN EUROPE-EU,GREECE,2,EDINBURGH,RHODES,32239,32239,0,3301,3301,0,876.64344
20/03/2023 10:46,2022,1,WESTERN EUROPE-EU,GREECE,2,EDINBURGH,SALONIKA,7421,7421,0,0,0,0,0
20/03/2023 10:46,2022,1,WESTERN EUROPE-EU,GREECE,2,EDINBURGH,SKIATHOS,5215,5215,0,0,0,0,0
20/03/2023 10:46,2022,1,WESTERN EUROPE-EU,GREECE,2,EDINBURGH,THIRA (SANTORINI),7237,7237,0,0,0,0,0
20/03/2023 10:46,2022,1,WESTERN EUROPE-EU,GREECE,2,EDINBURGH,ZAKINTHOS,13139,13139,0,0,0,0,0
20/03/2023 10:46,2022,1,WESTERN EUROPE-EU,GREECE,2,EXETER,CORFU,16002,0,16002,0,0,0,0
20/03/2023 10:46,2022,1,WESTERN EUROPE-EU,GREECE,2,EXETER,HERAKLION,7379,0,7379,0,0,0,0
20/03/2023 10:46,2022,1,WESTERN EUROPE-EU,GREECE,2,EXETER,RHODES,6908,0,6908,925,0,925,646.81081
20/03/2023 10:46,2022,1,WESTERN EUROPE-EU,GREECE,2,EXETER,ZAKINTHOS,16200,0,16200,0,0,0,0
20/03/2023 10:46,2022,1,WESTERN EUROPE-EU,GREECE,2,GLASGOW,CHANIA,6235,6235,0,0,0,0,0
20/03/2023 10:46,2022,1,WESTERN EUROPE-EU,GREECE,2,GLASGOW,CORFU,23290,8417,14873,1414,1414,0,1547.10042
20/03/2023 10:46,2022,1,WESTERN EUROPE-EU,GREECE,2,GLASGOW,HERAKLION,26858,26858,0,4211,4211,0,537.80575
20/03/2023 10:46,2022,1,WESTERN EUROPE-EU,GREECE,2,GLASGOW,KEFALLINIA,7419,7419,0,1029,1029,0,620.99125
20/03/2023 10:46,2022,1,WESTERN EUROPE-EU,GREECE,2,GLASGOW,KOS,27291,27291,0,5451,5451,0,400.66043
20/03/2023 10:46,2022,1,WESTERN EUROPE-EU,GREECE,2,GLASGOW,RHODES,38564,20588,17976,7109,4576,2533,442.46729
20/03/2023 10:46,2022,1,WESTERN EUROPE-EU,GREECE,2,GLASGOW,ZAKINTHOS,17320,9886,7434,3037,1923,1114,470.29964
20/03/2023 10:46,2022,1,WESTERN EUROPE-EU,GREECE,2,LEEDS BRADFORD,ATHENS,3,3,0,0,0,0,0
20/03/2023 10:46,2022,1,WESTERN EUROPE-EU,GREECE,2,LEEDS BRADFORD,CHANIA,16603,16443,160,5822,5822,0,185.17692
20/03/2023 10:46,2022,1,WESTERN EUROPE-EU,GREECE,2,LEEDS BRADFORD,CORFU,31615,23357,8258,5904,5904,0,435.48442
20/03/2023 10:46,2022,1,WESTERN EUROPE-EU,GREECE,2,LEEDS BRADFORD,HERAKLION,50299,50299,0,15403,15403,0,226.55327
20/03/2023 10:46,2022,1,WESTERN EUROPE-EU,GREECE,2,LEEDS BRADFORD,KEFALLINIA,20004,20004,0,3661,3661,0,446.40809
20/03/2023 10:46,2022,1,WESTERN EUROPE-EU,GREECE,2,LEEDS BRADFORD,KOS,23257,23257,0,9108,9108,0,155.34695
20/03/2023 10:46,2022,1,WESTERN EUROPE-EU,GREECE,2,LEEDS BRADFORD,RHODES,27564,27564,0,9335,9335,0,195.27584
20/03/2023 10:46,2022,1,WESTERN EUROPE-EU,GREECE,2,LEEDS BRADFORD,SALONIKA,7550,7550,0,0,0,0,0
20/03/2023 10:46,2022,1,WESTERN EUROPE-EU,GREECE,2,LEEDS BRADFORD,SKIATHOS,12694,12694,0,1157,1157,0,997.1478
20/03/2023 10:46,2022,1,WESTERN EUROPE-EU,GREECE,2,LEEDS BRADFORD,THIRA (SANTORINI),6889,6889,0,731,731,0,842.40766
20/03/2023 10:46,2022,1,WESTERN EUROPE-EU,GREECE,2,LEEDS BRADFORD,ZAKINTHOS,20988,20988,0,6680,6680,0,214.19162
20/03/2023 10:46,2022,1,WESTERN EUROPE-EU,GREECE,2,LIVERPOOL (JOHN LENNON),ATHENS,0,0,0,95,95,0,-100
20/03/2023 10:46,2022,1,WESTERN EUROPE-EU,GREECE,2,LIVERPOOL (JOHN LENNON),CORFU,0,0,0,6253,6253,0,-100
20/03/2023 10:46,2022,1,WESTERN EUROPE-EU,GREECE,2,LIVERPOOL (JOHN LENNON),HERAKLION,7577,7577,0,0,0,0,0
20/03/2023 10:46,2022,1,WESTERN EUROPE-EU,GREECE,2,LIVERPOOL (JOHN LENNON),KOS,2863,2863,0,2880,2880,0,-0.59028
20/03/2023 10:46,2022,1,WESTERN EUROPE-EU,GREECE,2,LIVERPOOL (JOHN LENNON),RHODES,0,0,0,7166,7166,0,-100
20/03/2023 10:46,2022,1,WESTERN EUROPE-EU,GREECE,2,LIVERPOOL (JOHN LENNON),ZAKINTHOS,0,0,0,3012,3012,0,-100
20/03/2023 10:46,2022,1,WESTERN EUROPE-EU,GREECE,2,MANCHESTER,ATHENS,123069,123069,0,33462,33462,0,267.78734
20/03/2023 10:46,2022,1,WESTERN EUROPE-EU,GREECE,2,MANCHESTER,CHANIA,73386,57291,16095,23603,17479,6124,210.9181
20/03/2023 10:46,2022,1,WESTERN EUROPE-EU,GREECE,2,MANCHESTER,CORFU,190733,150829,39904,55538,40492,15046,243.42792
20/03/2023 10:46,2022,1,WESTERN EUROPE-EU,GREECE,2,MANCHESTER,HERAKLION,178212,122753,55459,55533,33843,21690,220.91189
20/03/2023 10:46,2022,1,WESTERN EUROPE-EU,GREECE,2,MANCHESTER,KALAMATA,14586,14586,0,2682,2682,0,443.84787
20/03/2023 10:46,2022,1,WESTERN EUROPE-EU,GREECE,2,MANCHESTER,KAVALA,6594,0,6594,1521,0,1521,333.53057
20/03/2023 10:46,2022,1,WESTERN EUROPE-EU,GREECE,2,MANCHESTER,KEFALLINIA,85198,60728,24470,21662,16029,5633,293.30625
20/03/2023 10:46,2022,1,WESTERN EUROPE-EU,GREECE,2,MANCHESTER,KOS,130274,87840,42434,41653,24291,17362,212.76019
20/03/2023 10:46,2022,1,WESTERN EUROPE-EU,GREECE,2,MANCHESTER,MIKONOS,35604,35604,0,9033,9033,0,294.15477
20/03/2023 10:46,2022,1,WESTERN EUROPE-EU,GREECE,2,MANCHESTER,MYTILINI,13768,13768,0,2579,2579,0,433.85033
20/03/2023 10:46,2022,1,WESTERN EUROPE-EU,GREECE,2,MANCHESTER,PREVEZA,44344,33238,11106,12925,10616,2309,243.08704
20/03/2023 10:46,2022,1,WESTERN EUROPE-EU,GREECE,2,MANCHESTER,RHODES,214647,154056,60591,65056,35541,29515,229.9419
20/03/2023 10:46,2022,1,WESTERN EUROPE-EU,GREECE,2,MANCHESTER,SALONIKA,72187,58635,13552,30584,28704,1880,136.02864
20/03/2023 10:46,2022,1,WESTERN EUROPE-EU,GREECE,2,MANCHESTER,SKIATHOS,43161,22434,20727,13187,5956,7231,227.29961
20/03/2023 10:46,2022,1,WESTERN EUROPE-EU,GREECE,2,MANCHESTER,THIRA (SANTORINI),76891,61202,15689,27906,24264,3642,175.53573
20/03/2023 10:46,2022,1,WESTERN EUROPE-EU,GREECE,2,MANCHESTER,ZAKINTHOS,112552,70334,42218,29484,13386,16098,281.73925
20/03/2023 10:46,2022,1,WESTERN EUROPE-EU,GREECE,2,NEWCASTLE,CHANIA,19973,19973,0,0,0,0,0
20/03/2023 10:46,2022,1,WESTERN EUROPE-EU,GREECE,2,NEWCASTLE,CORFU,47313,47313,0,11435,11435,0,313.75601
20/03/2023 10:46,2022,1,WESTERN EUROPE-EU,GREECE,2,NEWCASTLE,HERAKLION,42203,42203,0,8902,8902,0,374.08448
20/03/2023 10:46,2022,1,WESTERN EUROPE-EU,GREECE,2,NEWCASTLE,KEFALLINIA,14131,14131,0,1622,1622,0,771.20838
20/03/2023 10:46,2022,1,WESTERN EUROPE-EU,GREECE,2,NEWCASTLE,KOS,31479,31479,0,4971,4971,0,533.25287
20/03/2023 10:46,2022,1,WESTERN EUROPE-EU,GREECE,2,NEWCASTLE,RHODES,48371,48371,0,12241,12241,0,295.15562
20/03/2023 10:46,2022,1,WESTERN EUROPE-EU,GREECE,2,NEWCASTLE,SALONIKA,7683,7683,0,0,0,0,0
20/03/2023 10:46,2022,1,WESTERN EUROPE-EU,GREECE,2,NEWCASTLE,SKIATHOS,12245,12245,0,2584,2584,0,373.87771
20/03/2023 10:46,2022,1,WESTERN EUROPE-EU,GREECE,2,NEWCASTLE,THIRA (SANTORINI),8014,8014,0,981,981,0,716.92151
20/03/2023 10:46,2022,1,WESTERN EUROPE-EU,GREECE,2,NEWCASTLE,ZAKINTHOS,47119,47119,0,10020,10020,0,370.2495
20/03/2023 10:46,2022,1,WESTERN EUROPE-EU,GREECE,2,NORWICH,CORFU,8577,0,8577,2575,0,2575,233.08738
20/03/2023 10:46,2022,1,WESTERN EUROPE-EU,GREECE,2,NORWICH,HERAKLION,8512,0,8512,0,0,0,0
20/03/2023 10:46,2022,1,WESTERN EUROPE-EU,GREECE,2,NORWICH,RHODES,8315,0,8315,0,0,0,0
20/03/2023 10:46,2022,1,WESTERN EUROPE-EU,GREECE,2,SOUTHAMPTON,MIKONOS,2205,2205,0,409,409,0,439.1198
20/03/2023 10:46,2022,1,WESTERN EUROPE-EU,GREECE,2,TEESSIDE INTERNATIONAL AIRPORT,CORFU,5563,5563,0,2120,2120,0,162.40566
20/03/2023 10:46,2022,1,WESTERN EUROPE-EU,IRISH REPUBLIC,1,GATWICK,CORK,110358,110358,0,6126,6126,0,1701.46915
20/03/2023 10:46,2022,1,WESTERN EUROPE-EU,IRISH REPUBLIC,1,GATWICK,DUBLIN,1155114,1155037,77,319909,319850,59,261.07581
20/03/2023 10:46,2022,1,WESTERN EUROPE-EU,IRISH REPUBLIC,1,GATWICK,IRELAND WEST(KNOCK),63708,63708,0,2115,2115,0,2912.19858
20/03/2023 10:46,2022,1,WESTERN EUROPE-EU,IRISH REPUBLIC,1,GATWICK,SHANNON,109094,109094,0,33642,33529,113,224.27917
20/03/2023 10:46,2022,1,WESTERN EUROPE-EU,IRISH REPUBLIC,1,HEATHROW,CORK,297556,297556,0,52235,52235,0,469.6487
20/03/2023 10:46,2022,1,WESTERN EUROPE-EU,IRISH REPUBLIC,1,HEATHROW,DUBLIN,1320119,1320004,115,403547,403297,250,227.12893
20/03/2023 10:46,2022,1,WESTERN EUROPE-EU,IRISH REPUBLIC,1,HEATHROW,SHANNON,194272,194272,0,24105,24105,0,705.94068
20/03/2023 10:46,2022,1,WESTERN EUROPE-EU,IRISH REPUBLIC,1,LONDON CITY,DUBLIN,206945,206945,0,53442,53442,0,287.23289
20/03/2023 10:46,2022,1,WESTERN EUROPE-EU,IRISH REPUBLIC,1,LUTON,CORK,68339,68339,0,17681,17681,0,286.51094
20/03/2023 10:46,2022,1,WESTERN EUROPE-EU,IRISH REPUBLIC,1,LUTON,DUBLIN,328568,328568,0,85110,85110,0,286.05099
20/03/2023 10:46,2022,1,WESTERN EUROPE-EU,IRISH REPUBLIC,1,LUTON,IRELAND WEST(KNOCK),128994,128994,0,38084,38084,0,238.70917
20/03/2023 10:46,2022,1,WESTERN EUROPE-EU,IRISH REPUBLIC,1,LUTON,KERRY COUNTY,101351,101351,0,35166,35166,0,188.20736
20/03/2023 10:46,2022,1,WESTERN EUROPE-EU,IRISH REPUBLIC,1,LUTON,SHANNON,3593,3593,0,6065,6065,0,-40.75845
20/03/2023 10:46,2022,1,WESTERN EUROPE-EU,IRISH REPUBLIC,1,STANSTED,CORK,263107,263107,0,40658,40658,0,547.12234
20/03/2023 10:46,2022,1,WESTERN EUROPE-EU,IRISH REPUBLIC,1,STANSTED,DUBLIN,815761,815387,374,308546,308546,0,164.38878
20/03/2023 10:46,2022,1,WESTERN EUROPE-EU,IRISH REPUBLIC,1,STANSTED,IRELAND WEST(KNOCK),143243,143243,0,36506,36506,0,292.38207
20/03/2023 10:46,2022,1,WESTERN EUROPE-EU,IRISH REPUBLIC,1,STANSTED,KERRY COUNTY,69848,69848,0,24259,24259,0,187.92613
20/03/2023 10:46,2022,1,WESTERN EUROPE-EU,IRISH REPUBLIC,1,STANSTED,SHANNON,192173,192000,173,63554,63548,6,202.37751
20/03/2023 10:46,2022,1,WESTERN EUROPE-EU,IRISH REPUBLIC,2,ABERDEEN,CORK,0,0,0,203,11,192,-100
20/03/2023 10:46,2022,1,WESTERN EUROPE-EU,IRISH REPUBLIC,2,ABERDEEN,DUBLIN,27012,27012,0,3953,3953,0,583.32912
20/03/2023 10:46,2022,1,WESTERN EUROPE-EU,IRISH REPUBLIC,2,ABERDEEN,WATERFORD,0,0,0,34,0,34,-100
20/03/2023 10:46,2022,1,WESTERN EUROPE-EU,IRISH REPUBLIC,2,BELFAST CITY (GEORGE BEST),DUBLIN,16,16,0,0,0,0,0
20/03/2023 10:46,2022,1,WESTERN EUROPE-EU,IRISH REPUBLIC,2,BELFAST INTERNATIONAL,CORK,42,0,42,0,0,0,0
20/03/2023 10:46,2022,1,WESTERN EUROPE-EU,IRISH REPUBLIC,2,BELFAST INTERNATIONAL,DUBLIN,416,136,280,480,330,150,-13.33333
20/03/2023 10:46,2022,1,WESTERN EUROPE-EU,IRISH REPUBLIC,2,BELFAST INTERNATIONAL,KERRY COUNTY,120,0,120,0,0,0,0
20/03/2023 10:46,2022,1,WESTERN EUROPE-EU,IRISH REPUBLIC,2,BELFAST INTERNATIONAL,SHANNON,182,182,0,0,0,0,0
20/03/2023 10:46,2022,1,WESTERN EUROPE-EU,IRISH REPUBLIC,2,BIGGIN HILL,CORK,2,0,2,0,0,0,0
20/03/2023 10:46,2022,1,WESTERN EUROPE-EU,IRISH REPUBLIC,2,BIGGIN HILL,DUBLIN,22,0,22,6,0,6,266.66667
20/03/2023 10:46,2022,1,WESTERN EUROPE-EU,IRISH REPUBLIC,2,BIGGIN HILL,IRELAND WEST(KNOCK),0,0,0,13,0,13,-100
20/03/2023 10:46,2022,1,WESTERN EUROPE-EU,IRISH REPUBLIC,2,BIGGIN HILL,KERRY COUNTY,58,0,58,0,0,0,0
20/03/2023 10:46,2022,1,WESTERN EUROPE-EU,IRISH REPUBLIC,2,BIRMINGHAM,CORK,45248,45248,0,1898,1898,0,2283.98314
20/03/2023 10:46,2022,1,WESTERN EUROPE-EU,IRISH REPUBLIC,2,BIRMINGHAM,DUBLIN,673042,673042,0,183805,183652,153,266.17176
20/03/2023 10:46,2022,1,WESTERN EUROPE-EU,IRISH REPUBLIC,2,BIRMINGHAM,IRELAND WEST(KNOCK),21614,21614,0,7,0,7,308671.42857
20/03/2023 10:46,2022,1,WESTERN EUROPE-EU,IRISH REPUBLIC,2,BIRMINGHAM,SHANNON,33450,33202,248,3746,3519,227,792.95248
20/03/2023 10:46,2022,1,WESTERN EUROPE-EU,IRISH REPUBLIC,2,BOURNEMOUTH,DUBLIN,28983,28983,0,4016,4016,0,621.68825
20/03/2023 10:46,2022,1,WESTERN EUROPE-EU,IRISH REPUBLIC,2,BOURNEMOUTH,SHANNON,360,0,360,0,0,0,0
20/03/2023 10:46,2022,1,WESTERN EUROPE-EU,IRISH REPUBLIC,2,BRISTOL,DUBLIN,351152,351037,115,106005,105901,104,231.25985
20/03/2023 10:46,2022,1,WESTERN EUROPE-EU,IRISH REPUBLIC,2,BRISTOL,IRELAND WEST(KNOCK),35716,35716,0,10568,10568,0,237.96366
20/03/2023 10:46,2022,1,WESTERN EUROPE-EU,IRISH REPUBLIC,2,CARDIFF WALES,CORK,94,0,94,0,0,0,0
20/03/2023 10:46,2022,1,WESTERN EUROPE-EU,IRISH REPUBLIC,2,CARDIFF WALES,DUBLIN,64126,63330,796,7870,7003,867,714.81576
20/03/2023 10:46,2022,1,WESTERN EUROPE-EU,IRISH REPUBLIC,2,CARDIFF WALES,SHANNON,266,0,266,1044,432,612,-74.52107
20/03/2023 10:46,2022,1,WESTERN EUROPE-EU,IRISH REPUBLIC,2,DONCASTER SHEFFIELD,SHANNON,47,0,47,0,0,0,0
20/03/2023 10:46,2022,1,WESTERN EUROPE-EU,IRISH REPUBLIC,2,DUNDEE,DUBLIN,0,0,0,9,0,9,-100
20/03/2023 10:46,2022,1,WESTERN EUROPE-EU,IRISH REPUBLIC,2,EAST MIDLANDS INTERNATIONAL,DUBLIN,136552,136297,255,27247,27247,0,401.16343
20/03/2023 10:46,2022,1,WESTERN EUROPE-EU,IRISH REPUBLIC,2,EAST MIDLANDS INTERNATIONAL,IRELAND WEST(KNOCK),44535,44535,0,12100,12100,0,268.05785
20/03/2023 10:46,2022,1,WESTERN EUROPE-EU,IRISH REPUBLIC,2,EDINBURGH,CORK,131059,131059,0,2494,2494,0,5154.97193
20/03/2023 10:46,2022,1,WESTERN EUROPE-EU,IRISH REPUBLIC,2,EDINBURGH,DUBLIN,572050,571842,208,157626,157255,371,262.91602
20/03/2023 10:46,2022,1,WESTERN EUROPE-EU,IRISH REPUBLIC,2,EDINBURGH,IRELAND WEST(KNOCK),36452,36452,0,6292,6292,0,479.33884
20/03/2023 10:46,2022,1,WESTERN EUROPE-EU,IRISH REPUBLIC,2,EDINBURGH,SHANNON,37581,37284,297,5721,5584,137,556.89565
20/03/2023 10:46,2022,1,WESTERN EUROPE-EU,IRISH REPUBLIC,2,EXETER,DUBLIN,17019,17019,0,90,0,90,18810
20/03/2023 10:46,2022,1,WESTERN EUROPE-EU,IRISH REPUBLIC,2,EXETER,SHANNON,547,0,547,91,0,91,501.0989
20/03/2023 10:46,2022,1,WESTERN EUROPE-EU,IRISH REPUBLIC,2,GLASGOW,DONEGAL,0,0,0,1534,1534,0,-100
20/03/2023 10:46,2022,1,WESTERN EUROPE-EU,IRISH REPUBLIC,2,GLASGOW,DUBLIN,402362,401852,510,94876,94577,299,324.0925
20/03/2023 10:46,2022,1,WESTERN EUROPE-EU,IRISH REPUBLIC,2,GLASGOW,IRELAND WEST(KNOCK),89,0,89,0,0,0,0
20/03/2023 10:46,2022,1,WESTERN EUROPE-EU,IRISH REPUBLIC,2,GLASGOW,SHANNON,161,0,161,45,0,45,257.77778
20/03/2023 10:46,2022,1,WESTERN EUROPE-EU,IRISH REPUBLIC,2,GUERNSEY,CORK,122,122,0,0,0,0,0
20/03/2023 10:46,2022,1,WESTERN EUROPE-EU,IRISH REPUBLIC,2,GUERNSEY,DUBLIN,6984,6984,0,37,0,37,18775.67568
20/03/2023 10:46,2022,1,WESTERN EUROPE-EU,IRISH REPUBLIC,2,INVERNESS,DUBLIN,5489,5489,0,0,0,0,0
20/03/2023 10:46,2022,1,WESTERN EUROPE-EU,IRISH REPUBLIC,2,INVERNESS,SHANNON,6,0,6,0,0,0,0
20/03/2023 10:46,2022,1,WESTERN EUROPE-EU,IRISH REPUBLIC,2,ISLE OF MAN,DUBLIN,25287,25287,0,0,0,0,0
20/03/2023 10:46,2022,1,WESTERN EUROPE-EU,IRISH REPUBLIC,2,JERSEY,DUBLIN,11830,11830,0,95,53,42,12352.63158
20/03/2023 10:46,2022,1,WESTERN EUROPE-EU,IRISH REPUBLIC,2,LEEDS BRADFORD,DUBLIN,228346,228157,189,41371,41371,0,451.94702
20/03/2023 10:46,2022,1,WESTERN EUROPE-EU,IRISH REPUBLIC,2,LIVERPOOL (JOHN LENNON),CORK,56486,56486,0,9781,9781,0,477.50741
20/03/2023 10:46,2022,1,WESTERN EUROPE-EU,IRISH REPUBLIC,2,LIVERPOOL (JOHN LENNON),DUBLIN,338156,338156,0,72061,71987,74,369.26354
20/03/2023 10:46,2022,1,WESTERN EUROPE-EU,IRISH REPUBLIC,2,LIVERPOOL (JOHN LENNON),IRELAND WEST(KNOCK),83846,83846,0,29866,29866,0,180.74064
20/03/2023 10:46,2022,1,WESTERN EUROPE-EU,IRISH REPUBLIC,2,MANCHESTER,CORK,163188,163118,70,2508,2508,0,6406.69856
20/03/2023 10:46,2022,1,WESTERN EUROPE-EU,IRISH REPUBLIC,2,MANCHESTER,DUBLIN,810494,810410,84,250163,250137,26,223.98636
20/03/2023 10:46,2022,1,WESTERN EUROPE-EU,IRISH REPUBLIC,2,MANCHESTER,IRELAND WEST(KNOCK),25301,25301,0,8219,8219,0,207.8355
20/03/2023 10:46,2022,1,WESTERN EUROPE-EU,IRISH REPUBLIC,2,MANCHESTER,KERRY COUNTY,24061,24061,0,10924,10924,0,120.25815
20/03/2023 10:46,2022,1,WESTERN EUROPE-EU,IRISH REPUBLIC,2,MANCHESTER,SHANNON,62192,62192,0,17168,17168,0,262.25536
20/03/2023 10:46,2022,1,WESTERN EUROPE-EU,IRISH REPUBLIC,2,NEWCASTLE,CORK,4602,4602,0,0,0,0,0
20/03/2023 10:46,2022,1,WESTERN EUROPE-EU,IRISH REPUBLIC,2,NEWCASTLE,DUBLIN,176672,176672,0,41775,41775,0,322.91323
20/03/2023 10:46,2022,1,WESTERN EUROPE-EU,IRISH REPUBLIC,2,NEWCASTLE,SHANNON,39,0,39,0,0,0,0
20/03/2023 10:46,2022,1,WESTERN EUROPE-EU,IRISH REPUBLIC,2,NEWQUAY,DUBLIN,17399,17399,0,56,56,0,30969.64286
20/03/2023 10:46,2022,1,WESTERN EUROPE-EU,IRISH REPUBLIC,2,PRESTWICK,DUBLIN,905,499,406,0,0,0,0
20/03/2023 10:46,2022,1,WESTERN EUROPE-EU,IRISH REPUBLIC,2,PRESTWICK,SHANNON,180,140,40,0,0,0,0
20/03/2023 10:46,2022,1,WESTERN EUROPE-EU,IRISH REPUBLIC,2,SOUTHAMPTON,CORK,64,0,64,0,0,0,0
20/03/2023 10:46,2022,1,WESTERN EUROPE-EU,IRISH REPUBLIC,2,SOUTHAMPTON,DUBLIN,30561,30493,68,7636,7636,0,300.22263
20/03/2023 10:46,2022,1,WESTERN EUROPE-EU,IRISH REPUBLIC,2,SOUTHAMPTON,KERRY COUNTY,905,3,902,0,0,0,0
20/03/2023 10:46,2022,1,WESTERN EUROPE-EU,IRISH REPUBLIC,2,SOUTHAMPTON,SHANNON,275,0,275,0,0,0,0
20/03/2023 10:46,2022,1,WESTERN EUROPE-EU,IRISH REPUBLIC,2,TEESSIDE INTERNATIONAL AIRPORT,DUBLIN,1675,1675,0,0,0,0,0
20/03/2023 10:46,2022,1,WESTERN EUROPE-EU,ITALY,1,GATWICK,BARI (PALESE),120287,120287,0,3747,3747,0,3110.22151
20/03/2023 10:46,2022,1,WESTERN EUROPE-EU,ITALY,1,GATWICK,BERGAMO,39781,39781,0,2536,2493,43,1468.65142
20/03/2023 10:46,2022,1,WESTERN EUROPE-EU,ITALY,1,GATWICK,BOLOGNA,35658,35658,0,140,140,0,25370
20/03/2023 10:46,2022,1,WESTERN EUROPE-EU,ITALY,1,GATWICK,BRINDISI,22447,22447,0,0,0,0,0
20/03/2023 10:46,2022,1,WESTERN EUROPE-EU,ITALY,1,GATWICK,CAGLIARI (ELMAS),61665,58917,2748,1273,1273,0,4744.06913
20/03/2023 10:46,2022,1,WESTERN EUROPE-EU,ITALY,1,GATWICK,CATANIA (FONTANAROSSA),201103,200837,266,22126,22126,0,808.89903
20/03/2023 10:46,2022,1,WESTERN EUROPE-EU,ITALY,1,GATWICK,FLORENCE,130618,130618,0,21265,21265,0,514.23936
20/03/2023 10:46,2022,1,WESTERN EUROPE-EU,ITALY,1,GATWICK,GENOA,12045,11998,47,0,0,0,0
20/03/2023 10:46,2022,1,WESTERN EUROPE-EU,ITALY,1,GATWICK,LAMETIA-TERME,8211,0,8211,0,0,0,0
20/03/2023 10:46,2022,1,WESTERN EUROPE-EU,ITALY,1,GATWICK,MILAN (LINATE),84274,84272,2,16905,16905,0,398.51523
20/03/2023 10:46,2022,1,WESTERN EUROPE-EU,ITALY,1,GATWICK,MILAN (MALPENSA),553763,553636,127,62005,61635,370,793.09411
20/03/2023 10:46,2022,1,WESTERN EUROPE-EU,ITALY,1,GATWICK,NAPLES,266352,246268,20084,26495,26495,0,905.29156
20/03/2023 10:46,2022,1,WESTERN EUROPE-EU,ITALY,1,GATWICK,OLBIA,90867,78898,11969,11793,11623,170,670.51641
20/03/2023 10:46,2022,1,WESTERN EUROPE-EU,ITALY,1,GATWICK,PALERMO,63455,63455,0,2886,2886,0,2098.71795
20/03/2023 10:46,2022,1,WESTERN EUROPE-EU,ITALY,1,GATWICK,PISA,153477,153477,0,17867,17867,0,758.99703
20/03/2023 10:46,2022,1,WESTERN EUROPE-EU,ITALY,1,GATWICK,ROME (CIAMPINO),0,0,0,90,0,90,-100
20/03/2023 10:46,2022,1,WESTERN EUROPE-EU,ITALY,1,GATWICK,ROME (FIUMICINO),573555,571788,1767,46743,46343,400,1127.03934
20/03/2023 10:46,2022,1,WESTERN EUROPE-EU,ITALY,1,GATWICK,TRIESTE (RONCHI DEI LEGIONARI),104,0,104,0,0,0,0
20/03/2023 10:46,2022,1,WESTERN EUROPE-EU,ITALY,1,GATWICK,TURIN,111412,95356,16056,4234,2350,1884,2531.36514
20/03/2023 10:46,2022,1,WESTERN EUROPE-EU,ITALY,1,GATWICK,VENICE,323812,323812,0,18538,18538,0,1646.74722
20/03/2023 10:46,2022,1,WESTERN EUROPE-EU,ITALY,1,GATWICK,VERONA VILLAFRANCA,173664,155596,18068,8990,8485,505,1831.74638
20/03/2023 10:46,2022,1,WESTERN EUROPE-EU,ITALY,1,HEATHROW,BARI (PALESE),0,0,0,6406,6406,0,-100
20/03/2023 10:46,2022,1,WESTERN EUROPE-EU,ITALY,1,HEATHROW,BERGAMO,914,914,0,11,0,11,8209.09091
20/03/2023 10:46,2022,1,WESTERN EUROPE-EU,ITALY,1,HEATHROW,BOLOGNA,201891,201891,0,29723,29651,72,579.24166
20/03/2023 10:46,2022,1,WESTERN EUROPE-EU,ITALY,1,HEATHROW,BRINDISI,26292,26292,0,0,0,0,0
20/03/2023 10:46,2022,1,WESTERN EUROPE-EU,ITALY,1,HEATHROW,CATANIA (FONTANAROSSA),30080,30080,0,9651,9473,178,211.67755
20/03/2023 10:46,2022,1,WESTERN EUROPE-EU,ITALY,1,HEATHROW,FLORENCE,346,346,0,0,0,0,0
20/03/2023 10:46,2022,1,WESTERN EUROPE-EU,ITALY,1,HEATHROW,MILAN (LINATE),463266,463266,0,183223,183223,0,152.84271
20/03/2023 10:46,2022,1,WESTERN EUROPE-EU,ITALY,1,HEATHROW,MILAN (MALPENSA),216926,216926,0,41956,41275,681,417.03213
20/03/2023 10:46,2022,1,WESTERN EUROPE-EU,ITALY,1,HEATHROW,NAPLES,180259,180259,0,40833,40737,96,341.45422
20/03/2023 10:46,2022,1,WESTERN EUROPE-EU,ITALY,1,HEATHROW,OLBIA,38509,38509,0,0,0,0,0
20/03/2023 10:46,2022,1,WESTERN EUROPE-EU,ITALY,1,HEATHROW,PALERMO,22472,22472,0,1758,1593,165,1178.27076
20/03/2023 10:46,2022,1,WESTERN EUROPE-EU,ITALY,1,HEATHROW,PERUGIA,19610,19610,0,0,0,0,0
20/03/2023 10:46,2022,1,WESTERN EUROPE-EU,ITALY,1,HEATHROW,PISA,134557,134557,0,32516,32516,0,313.81781
20/03/2023 10:46,2022,1,WESTERN EUROPE-EU,ITALY,1,HEATHROW,RIMINI,0,0,0,88,0,88,-100
20/03/2023 10:46,2022,1,WESTERN EUROPE-EU,ITALY,1,HEATHROW,ROME (FIUMICINO),576295,576180,115,211846,211536,310,172.03487
20/03/2023 10:46,2022,1,WESTERN EUROPE-EU,ITALY,1,HEATHROW,TURIN,29260,29260,0,3382,3174,208,765.16854
20/03/2023 10:46,2022,1,WESTERN EUROPE-EU,ITALY,1,HEATHROW,VENICE,296739,296739,0,68228,68228,0,334.92261
20/03/2023 10:46,2022,1,WESTERN EUROPE-EU,ITALY,1,HEATHROW,VERONA VILLAFRANCA,5494,5494,0,1023,1023,0,437.0479
20/03/2023 10:46,2022,1,WESTERN EUROPE-EU,ITALY,1,LONDON CITY,FLORENCE,95467,95467,0,17999,17999,0,430.40169
20/03/2023 10:46,2022,1,WESTERN EUROPE-EU,ITALY,1,LONDON CITY,MILAN (LINATE),81499,81499,0,0,0,0,0
20/03/2023 10:46,2022,1,WESTERN EUROPE-EU,ITALY,1,LONDON CITY,MILAN (MALPENSA),31350,31350,0,0,0,0,0
20/03/2023 10:46,2022,1,WESTERN EUROPE-EU,ITALY,1,LONDON CITY,PISA,132,132,0,0,0,0,0
20/03/2023 10:46,2022,1,WESTERN EUROPE-EU,ITALY,1,LUTON,BARI (PALESE),123,123,0,0,0,0,0
20/03/2023 10:46,2022,1,WESTERN EUROPE-EU,ITALY,1,LUTON,BOLOGNA,54924,54755,169,10335,10335,0,431.43687
20/03/2023 10:46,2022,1,WESTERN EUROPE-EU,ITALY,1,LUTON,CATANIA (FONTANAROSSA),71082,71082,0,10552,10552,0,573.63533
20/03/2023 10:46,2022,1,WESTERN EUROPE-EU,ITALY,1,LUTON,MILAN (MALPENSA),92489,92489,0,46496,46496,0,98.91819
20/03/2023 10:46,2022,1,WESTERN EUROPE-EU,ITALY,1,LUTON,NAPLES,134023,133802,221,28529,28529,0,369.77812
20/03/2023 10:46,2022,1,WESTERN EUROPE-EU,ITALY,1,LUTON,OLBIA,9149,9149,0,0,0,0,0
20/03/2023 10:46,2022,1,WESTERN EUROPE-EU,ITALY,1,LUTON,PALERMO,27403,27403,0,8269,8269,0,231.39436
20/03/2023 10:46,2022,1,WESTERN EUROPE-EU,ITALY,1,LUTON,PISA,17301,17301,0,95,95,0,18111.57895
20/03/2023 10:46,2022,1,WESTERN EUROPE-EU,ITALY,1,LUTON,RIMINI,0,0,0,295,0,295,-100
20/03/2023 10:46,2022,1,WESTERN EUROPE-EU,ITALY,1,LUTON,ROME (FIUMICINO),12197,12197,0,15017,14779,238,-18.77872
20/03/2023 10:46,2022,1,WESTERN EUROPE-EU,ITALY,1,LUTON,TURIN,3981,3981,0,594,594,0,570.20202
20/03/2023 10:46,2022,1,WESTERN EUROPE-EU,ITALY,1,LUTON,VENICE,30949,30949,0,0,0,0,0
20/03/2023 10:46,2022,1,WESTERN EUROPE-EU,ITALY,1,STANSTED,ALGHERO (FERTILIA),24778,24778,0,10038,10038,0,146.842
20/03/2023 10:46,2022,1,WESTERN EUROPE-EU,ITALY,1,STANSTED,ANCONA,82670,82670,0,25720,25720,0,221.42302
20/03/2023 10:46,2022,1,WESTERN EUROPE-EU,ITALY,1,STANSTED,BARI (PALESE),104585,104585,0,41572,41572,0,151.57558
20/03/2023 10:46,2022,1,WESTERN EUROPE-EU,ITALY,1,STANSTED,BERGAMO,441375,441375,0,125359,125359,0,252.0888
20/03/2023 10:46,2022,1,WESTERN EUROPE-EU,ITALY,1,STANSTED,BOLOGNA,186890,186890,0,48416,48416,0,286.00876
20/03/2023 10:46,2022,1,WESTERN EUROPE-EU,ITALY,1,STANSTED,BRINDISI,62335,62335,0,22872,22872,0,172.53847
20/03/2023 10:46,2022,1,WESTERN EUROPE-EU,ITALY,1,STANSTED,CAGLIARI (ELMAS),55748,55580,168,16973,16973,0,228.45107
20/03/2023 10:46,2022,1,WESTERN EUROPE-EU,ITALY,1,STANSTED,CATANIA (FONTANAROSSA),15259,15259,0,0,0,0,0
20/03/2023 10:46,2022,1,WESTERN EUROPE-EU,ITALY,1,STANSTED,FLORENCE,90,90,0,0,0,0,0
20/03/2023 10:46,2022,1,WESTERN EUROPE-EU,ITALY,1,STANSTED,GENOA,61795,61795,0,20228,20228,0,205.49239
20/03/2023 10:46,2022,1,WESTERN EUROPE-EU,ITALY,1,STANSTED,LAMETIA-TERME,49169,49169,0,16527,16527,0,197.50711
20/03/2023 10:46,2022,1,WESTERN EUROPE-EU,ITALY,1,STANSTED,MILAN (LINATE),53,53,0,0,0,0,0
20/03/2023 10:46,2022,1,WESTERN EUROPE-EU,ITALY,1,STANSTED,MILAN (MALPENSA),300009,300009,0,74845,74845,0,300.8404
20/03/2023 10:46,2022,1,WESTERN EUROPE-EU,ITALY,1,STANSTED,NAPLES,172551,172551,0,52859,52859,0,226.43637
20/03/2023 10:46,2022,1,WESTERN EUROPE-EU,ITALY,1,STANSTED,OLBIA,7040,7040,0,0,0,0,0
20/03/2023 10:46,2022,1,WESTERN EUROPE-EU,ITALY,1,STANSTED,PALERMO,106339,106339,0,44772,44772,0,137.51228
20/03/2023 10:46,2022,1,WESTERN EUROPE-EU,ITALY,1,STANSTED,PERUGIA,76066,76066,0,22837,22837,0,233.08228
20/03/2023 10:46,2022,1,WESTERN EUROPE-EU,ITALY,1,STANSTED,PESCARA,77431,77431,0,24831,24831,0,211.83198
20/03/2023 10:46,2022,1,WESTERN EUROPE-EU,ITALY,1,STANSTED,PISA,256933,256933,0,63039,63039,0,307.57785
20/03/2023 10:46,2022,1,WESTERN EUROPE-EU,ITALY,1,STANSTED,RIMINI,11446,11446,0,4522,4522,0,153.11809
20/03/2023 10:46,2022,1,WESTERN EUROPE-EU,ITALY,1,STANSTED,ROME (CIAMPINO),470293,470293,0,120411,120411,0,290.57312
20/03/2023 10:46,2022,1,WESTERN EUROPE-EU,ITALY,1,STANSTED,ROME (FIUMICINO),1954,1106,848,542,542,0,260.51661
20/03/2023 10:46,2022,1,WESTERN EUROPE-EU,ITALY,1,STANSTED,TRAPANI,24216,24216,0,612,612,0,3856.86275
20/03/2023 10:46,2022,1,WESTERN EUROPE-EU,ITALY,1,STANSTED,TREVISO,44021,44021,0,32153,32153,0,36.91102
20/03/2023 10:46,2022,1,WESTERN EUROPE-EU,ITALY,1,STANSTED,TRIESTE (RONCHI DEI LEGIONARI),49939,49939,0,13445,13445,0,271.43176
20/03/2023 10:46,2022,1,WESTERN EUROPE-EU,ITALY,1,STANSTED,TURIN,128625,123343,5282,40948,40501,447,214.11791
20/03/2023 10:46,2022,1,WESTERN EUROPE-EU,ITALY,1,STANSTED,VENICE,271495,271369,126,64827,64827,0,318.79927
20/03/2023 10:46,2022,1,WESTERN EUROPE-EU,ITALY,1,STANSTED,VERONA VILLAFRANCA,73062,73062,0,15866,15866,0,360.49414
20/03/2023 10:46,2022,1,WESTERN EUROPE-EU,ITALY,2,ABERDEEN,CATANIA (FONTANAROSSA),0,0,0,40,0,40,-100
20/03/2023 10:46,2022,1,WESTERN EUROPE-EU,ITALY,2,BELFAST CITY (GEORGE BEST),BERGAMO,0,0,0,605,605,0,-100
20/03/2023 10:46,2022,1,WESTERN EUROPE-EU,ITALY,2,BELFAST CITY (GEORGE BEST),MILAN (MALPENSA),0,0,0,35,0,35,-100
20/03/2023 10:46,2022,1,WESTERN EUROPE-EU,ITALY,2,BELFAST CITY (GEORGE BEST),PISA,0,0,0,34,0,34,-100
20/03/2023 10:46,2022,1,WESTERN EUROPE-EU,ITALY,2,BELFAST CITY (GEORGE BEST),TRIESTE (RONCHI DEI LEGIONARI),41,0,41,0,0,0,0
20/03/2023 10:46,2022,1,WESTERN EUROPE-EU,ITALY,2,BELFAST INTERNATIONAL,BERGAMO,0,0,0,1064,1064,0,-100
20/03/2023 10:46,2022,1,WESTERN EUROPE-EU,ITALY,2,BELFAST INTERNATIONAL,MILAN (MALPENSA),40,0,40,83,0,83,-51.80723
20/03/2023 10:46,2022,1,WESTERN EUROPE-EU,ITALY,2,BELFAST INTERNATIONAL,PARMA,0,0,0,268,0,268,-100
20/03/2023 10:46,2022,1,WESTERN EUROPE-EU,ITALY,2,BELFAST INTERNATIONAL,TREVISO,0,0,0,43,43,0,-100
20/03/2023 10:46,2022,1,WESTERN EUROPE-EU,ITALY,2,BELFAST INTERNATIONAL,VENICE,66,0,66,43,43,0,53.48837
20/03/2023 10:46,2022,1,WESTERN EUROPE-EU,ITALY,2,BELFAST INTERNATIONAL,VERONA VILLAFRANCA,5971,5971,0,0,0,0,0
20/03/2023 10:46,2022,1,WESTERN EUROPE-EU,ITALY,2,BIGGIN HILL,ALBENGA,0,0,0,12,0,12,-100
20/03/2023 10:46,2022,1,WESTERN EUROPE-EU,ITALY,2,BIGGIN HILL,ANCONA,1,0,1,0,0,0,0
20/03/2023 10:46,2022,1,WESTERN EUROPE-EU,ITALY,2,BIGGIN HILL,BARI (PALESE),0,0,0,4,0,4,-100
20/03/2023 10:46,2022,1,WESTERN EUROPE-EU,ITALY,2,BIGGIN HILL,BERGAMO,0,0,0,95,0,95,-100
20/03/2023 10:46,2022,1,WESTERN EUROPE-EU,ITALY,2,BIGGIN HILL,BOLOGNA,6,0,6,0,0,0,0
20/03/2023 10:46,2022,1,WESTERN EUROPE-EU,ITALY,2,BIGGIN HILL,BRESCIA/MONTICHIARI,2,0,2,0,0,0,0
20/03/2023 10:46,2022,1,WESTERN EUROPE-EU,ITALY,2,BIGGIN HILL,CATANIA (FONTANAROSSA),1,0,1,9,0,9,-88.88889
20/03/2023 10:46,2022,1,WESTERN EUROPE-EU,ITALY,2,BIGGIN HILL,FLORENCE,11,0,11,22,0,22,-50
20/03/2023 10:46,2022,1,WESTERN EUROPE-EU,ITALY,2,BIGGIN HILL,GENOA,0,0,0,9,0,9,-100
20/03/2023 10:46,2022,1,WESTERN EUROPE-EU,ITALY,2,BIGGIN HILL,MILAN (LINATE),49,0,49,16,0,16,206.25
20/03/2023 10:46,2022,1,WESTERN EUROPE-EU,ITALY,2,BIGGIN HILL,MILAN (MALPENSA),5,0,5,11,0,11,-54.54545
20/03/2023 10:46,2022,1,WESTERN EUROPE-EU,ITALY,2,BIGGIN HILL,NAPLES,42,0,42,21,0,21,100
20/03/2023 10:46,2022,1,WESTERN EUROPE-EU,ITALY,2,BIGGIN HILL,OLBIA,20,0,20,13,0,13,53.84615
20/03/2023 10:46,2022,1,WESTERN EUROPE-EU,ITALY,2,BIGGIN HILL,PALERMO,12,0,12,0,0,0,0
20/03/2023 10:46,2022,1,WESTERN EUROPE-EU,ITALY,2,BIGGIN HILL,PERUGIA,2,0,2,10,0,10,-80
20/03/2023 10:46,2022,1,WESTERN EUROPE-EU,ITALY,2,BIGGIN HILL,PISA,25,0,25,0,0,0,0
20/03/2023 10:46,2022,1,WESTERN EUROPE-EU,ITALY,2,BIGGIN HILL,ROME (CIAMPINO),13,0,13,25,0,25,-48
20/03/2023 10:46,2022,1,WESTERN EUROPE-EU,ITALY,2,BIGGIN HILL,VENICE,104,0,104,7,0,7,1385.71429
20/03/2023 10:46,2022,1,WESTERN EUROPE-EU,ITALY,2,BIGGIN HILL,VERONA VILLAFRANCA,0,0,0,2,0,2,-100
20/03/2023 10:46,2022,1,WESTERN EUROPE-EU,ITALY,2,BIRMINGHAM,BERGAMO,31694,31694,0,4248,4248,0,646.09228
20/03/2023 10:46,2022,1,WESTERN EUROPE-EU,ITALY,2,BIRMINGHAM,BOLOGNA,90,0,90,756,0,756,-88.09524
20/03/2023 10:46,2022,1,WESTERN EUROPE-EU,ITALY,2,BIRMINGHAM,MILAN (LINATE),61,0,61,0,0,0,0
20/03/2023 10:46,2022,1,WESTERN EUROPE-EU,ITALY,2,BIRMINGHAM,MILAN (MALPENSA),0,0,0,568,0,568,-100
20/03/2023 10:46,2022,1,WESTERN EUROPE-EU,ITALY,2,BIRMINGHAM,NAPLES,40050,19520,20530,200,0,200,19925
20/03/2023 10:46,2022,1,WESTERN EUROPE-EU,ITALY,2,BIRMINGHAM,PISA,6218,6218,0,0,0,0,0
20/03/2023 10:46,2022,1,WESTERN EUROPE-EU,ITALY,2,BIRMINGHAM,ROME (FIUMICINO),51560,49863,1697,121,0,121,42511.57025
20/03/2023 10:46,2022,1,WESTERN EUROPE-EU,ITALY,2,BIRMINGHAM,TURIN,11273,5943,5330,943,468,475,1095.44008
20/03/2023 10:46,2022,1,WESTERN EUROPE-EU,ITALY,2,BIRMINGHAM,VENICE,21389,21389,0,0,0,0,0
20/03/2023 10:46,2022,1,WESTERN EUROPE-EU,ITALY,2,BIRMINGHAM,VERONA VILLAFRANCA,56621,40737,15884,8793,8625,168,543.93267
20/03/2023 10:46,2022,1,WESTERN EUROPE-EU,ITALY,2,BOURNEMOUTH,BERGAMO,338,0,338,0,0,0,0
20/03/2023 10:46,2022,1,WESTERN EUROPE-EU,ITALY,2,BOURNEMOUTH,VENICE,1057,1057,0,0,0,0,0
20/03/2023 10:46,2022,1,WESTERN EUROPE-EU,ITALY,2,BRISTOL,BERGAMO,45011,45011,0,9262,9262,0,385.97495
20/03/2023 10:46,2022,1,WESTERN EUROPE-EU,ITALY,2,BRISTOL,CATANIA (FONTANAROSSA),20507,20507,0,1479,1479,0,1286.54496
20/03/2023 10:46,2022,1,WESTERN EUROPE-EU,ITALY,2,BRISTOL,MILAN (MALPENSA),25704,25704,0,6664,6664,0,285.71429
20/03/2023 10:46,2022,1,WESTERN EUROPE-EU,ITALY,2,BRISTOL,NAPLES,44367,27267,17100,3676,3676,0,1106.93689
20/03/2023 10:46,2022,1,WESTERN EUROPE-EU,ITALY,2,BRISTOL,OLBIA,24215,24215,0,1082,1082,0,2137.98521
20/03/2023 10:46,2022,1,WESTERN EUROPE-EU,ITALY,2,BRISTOL,PARMA,89,0,89,88,0,88,1.13636
20/03/2023 10:46,2022,1,WESTERN EUROPE-EU,ITALY,2,BRISTOL,PISA,37878,37878,0,3380,3380,0,1020.65089
20/03/2023 10:46,2022,1,WESTERN EUROPE-EU,ITALY,2,BRISTOL,ROME (FIUMICINO),70772,70146,626,5074,5074,0,1294.797
20/03/2023 10:46,2022,1,WESTERN EUROPE-EU,ITALY,2,BRISTOL,TREVISO,48427,48427,0,2742,2742,0,1666.11962
20/03/2023 10:46,2022,1,WESTERN EUROPE-EU,ITALY,2,BRISTOL,TURIN,9188,3887,5301,885,764,121,938.19209
20/03/2023 10:46,2022,1,WESTERN EUROPE-EU,ITALY,2,BRISTOL,VENICE,30313,30313,0,991,991,0,2958.82947
20/03/2023 10:46,2022,1,WESTERN EUROPE-EU,ITALY,2,BRISTOL,VERONA VILLAFRANCA,16629,5296,11333,400,0,400,4057.25
20/03/2023 10:46,2022,1,WESTERN EUROPE-EU,ITALY,2,CARDIFF WALES,BOLOGNA,80,0,80,51,51,0,56.86275
20/03/2023 10:46,2022,1,WESTERN EUROPE-EU,ITALY,2,CARDIFF WALES,MILAN (MALPENSA),1648,1648,0,0,0,0,0
20/03/2023 10:46,2022,1,WESTERN EUROPE-EU,ITALY,2,CARDIFF WALES,PARMA,338,0,338,307,221,86,10.09772
20/03/2023 10:46,2022,1,WESTERN EUROPE-EU,ITALY,2,CARDIFF WALES,ROME (FIUMICINO),47,0,47,236,0,236,-80.08475
20/03/2023 10:46,2022,1,WESTERN EUROPE-EU,ITALY,2,CARDIFF WALES,TREVISO,85,0,85,138,44,94,-38.4058
20/03/2023 10:46,2022,1,WESTERN EUROPE-EU,ITALY,2,CARDIFF WALES,VENICE,329,0,329,274,224,50,20.07299
20/03/2023 10:46,2022,1,WESTERN EUROPE-EU,ITALY,2,CARDIFF WALES,VERONA VILLAFRANCA,44,0,44,0,0,0,0
20/03/2023 10:46,2022,1,WESTERN EUROPE-EU,ITALY,2,DONCASTER SHEFFIELD,FLORENCE,18,0,18,0,0,0,0
20/03/2023 10:46,2022,1,WESTERN EUROPE-EU,ITALY,2,DONCASTER SHEFFIELD,NAPLES,2,0,2,0,0,0,0
20/03/2023 10:46,2022,1,WESTERN EUROPE-EU,ITALY,2,DONCASTER SHEFFIELD,OLBIA,1658,0,1658,0,0,0,0
20/03/2023 10:46,2022,1,WESTERN EUROPE-EU,ITALY,2,DONCASTER SHEFFIELD,VENICE,113,0,113,0,0,0,0
20/03/2023 10:46,2022,1,WESTERN EUROPE-EU,ITALY,2,EAST MIDLANDS INTERNATIONAL,BERGAMO,51468,51468,0,10484,10484,0,390.9195
20/03/2023 10:46,2022,1,WESTERN EUROPE-EU,ITALY,2,EAST MIDLANDS INTERNATIONAL,NAPLES,14505,0,14505,0,0,0,0
20/03/2023 10:46,2022,1,WESTERN EUROPE-EU,ITALY,2,EAST MIDLANDS INTERNATIONAL,PISA,15604,15604,0,2557,2557,0,510.24638
20/03/2023 10:46,2022,1,WESTERN EUROPE-EU,ITALY,2,EAST MIDLANDS INTERNATIONAL,ROME (CIAMPINO),0,0,0,2552,2552,0,-100
20/03/2023 10:46,2022,1,WESTERN EUROPE-EU,ITALY,2,EAST MIDLANDS INTERNATIONAL,ROME (FIUMICINO),17685,17140,545,0,0,0,0
20/03/2023 10:46,2022,1,WESTERN EUROPE-EU,ITALY,2,EAST MIDLANDS INTERNATIONAL,TREVISO,27925,27925,0,4501,4501,0,520.41768
20/03/2023 10:46,2022,1,WESTERN EUROPE-EU,ITALY,2,EAST MIDLANDS INTERNATIONAL,VERONA VILLAFRANCA,6207,6207,0,0,0,0,0
20/03/2023 10:46,2022,1,WESTERN EUROPE-EU,ITALY,2,EDINBURGH,BARI (PALESE),19510,19510,0,0,0,0,0
20/03/2023 10:46,2022,1,WESTERN EUROPE-EU,ITALY,2,EDINBURGH,BERGAMO,80527,80527,0,27317,27317,0,194.78713
20/03/2023 10:46,2022,1,WESTERN EUROPE-EU,ITALY,2,EDINBURGH,BOLOGNA,36109,36109,0,2888,2888,0,1150.31163
20/03/2023 10:46,2022,1,WESTERN EUROPE-EU,ITALY,2,EDINBURGH,FLORENCE,10840,10674,166,0,0,0,0
20/03/2023 10:46,2022,1,WESTERN EUROPE-EU,ITALY,2,EDINBURGH,MILAN (MALPENSA),53347,53347,0,1251,1251,0,4164.34852
20/03/2023 10:46,2022,1,WESTERN EUROPE-EU,ITALY,2,EDINBURGH,NAPLES,60614,60614,0,5247,5247,0,1055.2125
20/03/2023 10:46,2022,1,WESTERN EUROPE-EU,ITALY,2,EDINBURGH,PALERMO,28099,28099,0,1794,1794,0,1466.27648
20/03/2023 10:46,2022,1,WESTERN EUROPE-EU,ITALY,2,EDINBURGH,PARMA,134,0,134,353,0,353,-62.03966
20/03/2023 10:46,2022,1,WESTERN EUROPE-EU,ITALY,2,EDINBURGH,PISA,29819,29819,0,5264,5264,0,466.47036
20/03/2023 10:46,2022,1,WESTERN EUROPE-EU,ITALY,2,EDINBURGH,ROME (CIAMPINO),83196,83196,0,14134,14044,90,488.62318
20/03/2023 10:46,2022,1,WESTERN EUROPE-EU,ITALY,2,EDINBURGH,ROME (FIUMICINO),1713,217,1496,0,0,0,0
20/03/2023 10:46,2022,1,WESTERN EUROPE-EU,ITALY,2,EDINBURGH,TREVISO,31236,31102,134,6087,5998,89,413.15919
20/03/2023 10:46,2022,1,WESTERN EUROPE-EU,ITALY,2,EDINBURGH,TURIN,22548,22548,0,379,379,0,5849.34037
20/03/2023 10:46,2022,1,WESTERN EUROPE-EU,ITALY,2,EDINBURGH,VENICE,20019,20019,0,1124,960,164,1681.04982
20/03/2023 10:46,2022,1,WESTERN EUROPE-EU,ITALY,2,EDINBURGH,VERONA VILLAFRANCA,8845,8371,474,0,0,0,0
20/03/2023 10:46,2022,1,WESTERN EUROPE-EU,ITALY,2,FARNBOROUGH,PERUGIA,0,0,0,1,0,1,-100
20/03/2023 10:46,2022,1,WESTERN EUROPE-EU,ITALY,2,GLASGOW,BOLOGNA,0,0,0,68,0,68,-100
20/03/2023 10:46,2022,1,WESTERN EUROPE-EU,ITALY,2,GLASGOW,NAPLES,17674,8257,9417,0,0,0,0
20/03/2023 10:46,2022,1,WESTERN EUROPE-EU,ITALY,2,GLASGOW,PARMA,167,0,167,172,0,172,-2.90698
20/03/2023 10:46,2022,1,WESTERN EUROPE-EU,ITALY,2,GLASGOW,ROME (FIUMICINO),24293,23741,552,59,0,59,41074.57627
20/03/2023 10:46,2022,1,WESTERN EUROPE-EU,ITALY,2,GLASGOW,TREVISO,42,0,42,0,0,0,0
20/03/2023 10:46,2022,1,WESTERN EUROPE-EU,ITALY,2,GLASGOW,TURIN,4570,0,4570,64,0,64,7040.625
20/03/2023 10:46,2022,1,WESTERN EUROPE-EU,ITALY,2,GLASGOW,VENICE,7364,7234,130,260,0,260,2732.30769
20/03/2023 10:46,2022,1,WESTERN EUROPE-EU,ITALY,2,GLASGOW,VERONA VILLAFRANCA,5886,0,5886,0,0,0,0
20/03/2023 10:46,2022,1,WESTERN EUROPE-EU,ITALY,2,GUERNSEY,BERGAMO,0,0,0,2,0,2,-100
20/03/2023 10:46,2022,1,WESTERN EUROPE-EU,ITALY,2,GUERNSEY,BOLOGNA,0,0,0,2,0,2,-100
20/03/2023 10:46,2022,1,WESTERN EUROPE-EU,ITALY,2,HUMBERSIDE,BERGAMO,324,0,324,0,0,0,0
20/03/2023 10:46,2022,1,WESTERN EUROPE-EU,ITALY,2,JERSEY,VENICE,123,0,123,0,0,0,0
20/03/2023 10:46,2022,1,WESTERN EUROPE-EU,ITALY,2,LEEDS BRADFORD,CAGLIARI (ELMAS),100,0,100,0,0,0,0
20/03/2023 10:46,2022,1,WESTERN EUROPE-EU,ITALY,2,LEEDS BRADFORD,CATANIA (FONTANAROSSA),6699,6699,0,0,0,0,0
20/03/2023 10:46,2022,1,WESTERN EUROPE-EU,ITALY,2,LEEDS BRADFORD,NAPLES,15746,15746,0,0,0,0,0
20/03/2023 10:46,2022,1,WESTERN EUROPE-EU,ITALY,2,LEEDS BRADFORD,PISA,4579,4579,0,2336,2336,0,96.01884
20/03/2023 10:46,2022,1,WESTERN EUROPE-EU,ITALY,2,LEEDS BRADFORD,ROME (FIUMICINO),14164,14164,0,0,0,0,0
20/03/2023 10:46,2022,1,WESTERN EUROPE-EU,ITALY,2,LEEDS BRADFORD,VERONA VILLAFRANCA,4863,4863,0,0,0,0,0
20/03/2023 10:46,2022,1,WESTERN EUROPE-EU,ITALY,2,LIVERPOOL (JOHN LENNON),BARI (PALESE),0,0,0,2116,2116,0,-100
20/03/2023 10:46,2022,1,WESTERN EUROPE-EU,ITALY,2,LIVERPOOL (JOHN LENNON),BERGAMO,24523,24523,0,1840,1537,303,1232.77174
20/03/2023 10:46,2022,1,WESTERN EUROPE-EU,ITALY,2,LIVERPOOL (JOHN LENNON),MILAN (MALPENSA),745,0,745,557,0,557,33.75224
20/03/2023 10:46,2022,1,WESTERN EUROPE-EU,ITALY,2,LIVERPOOL (JOHN LENNON),NAPLES,496,0,496,0,0,0,0
20/03/2023 10:46,2022,1,WESTERN EUROPE-EU,ITALY,2,LIVERPOOL (JOHN LENNON),ROME (CIAMPINO),7509,7509,0,0,0,0,0
20/03/2023 10:46,2022,1,WESTERN EUROPE-EU,ITALY,2,LIVERPOOL (JOHN LENNON),ROME (FIUMICINO),47261,47261,0,5014,5014,0,842.58077
20/03/2023 10:46,2022,1,WESTERN EUROPE-EU,ITALY,2,LIVERPOOL (JOHN LENNON),TURIN,62,0,62,0,0,0,0
20/03/2023 10:46,2022,1,WESTERN EUROPE-EU,ITALY,2,MANCHESTER,BARI (PALESE),41,0,41,0,0,0,0
20/03/2023 10:46,2022,1,WESTERN EUROPE-EU,ITALY,2,MANCHESTER,BERGAMO,150432,150432,0,55644,54792,852,170.34721
20/03/2023 10:46,2022,1,WESTERN EUROPE-EU,ITALY,2,MANCHESTER,BOLOGNA,52896,52896,0,18616,18471,145,184.14267
20/03/2023 10:46,2022,1,WESTERN EUROPE-EU,ITALY,2,MANCHESTER,BRINDISI,18354,18354,0,2347,2347,0,682.0196
20/03/2023 10:46,2022,1,WESTERN EUROPE-EU,ITALY,2,MANCHESTER,CAGLIARI (ELMAS),0,0,0,2156,2156,0,-100
20/03/2023 10:46,2022,1,WESTERN EUROPE-EU,ITALY,2,MANCHESTER,CATANIA (FONTANAROSSA),28168,28168,0,2784,2784,0,911.78161
20/03/2023 10:46,2022,1,WESTERN EUROPE-EU,ITALY,2,MANCHESTER,GENOA,20618,20618,0,0,0,0,0
20/03/2023 10:46,2022,1,WESTERN EUROPE-EU,ITALY,2,MANCHESTER,LAMETIA-TERME,8160,0,8160,0,0,0,0
20/03/2023 10:46,2022,1,WESTERN EUROPE-EU,ITALY,2,MANCHESTER,MILAN (MALPENSA),203628,203628,0,30884,30633,251,559.33169
20/03/2023 10:46,2022,1,WESTERN EUROPE-EU,ITALY,2,MANCHESTER,NAPLES,126119,105773,20346,16976,15960,1016,642.92531
20/03/2023 10:46,2022,1,WESTERN EUROPE-EU,ITALY,2,MANCHESTER,OLBIA,30945,30566,379,897,897,0,3349.83278
20/03/2023 10:46,2022,1,WESTERN EUROPE-EU,ITALY,2,MANCHESTER,PALERMO,8326,8326,0,5187,5187,0,60.51668
20/03/2023 10:46,2022,1,WESTERN EUROPE-EU,ITALY,2,MANCHESTER,PESCARA,15352,15352,0,0,0,0,0
20/03/2023 10:46,2022,1,WESTERN EUROPE-EU,ITALY,2,MANCHESTER,PISA,121692,121692,0,11691,11691,0,940.90326
20/03/2023 10:46,2022,1,WESTERN EUROPE-EU,ITALY,2,MANCHESTER,ROME (CIAMPINO),153243,153243,0,36850,36850,0,315.85617
20/03/2023 10:46,2022,1,WESTERN EUROPE-EU,ITALY,2,MANCHESTER,ROME (FIUMICINO),104530,103814,716,6931,6649,282,1408.15178
20/03/2023 10:46,2022,1,WESTERN EUROPE-EU,ITALY,2,MANCHESTER,TRAPANI,10586,10586,0,0,0,0,0
20/03/2023 10:46,2022,1,WESTERN EUROPE-EU,ITALY,2,MANCHESTER,TREVISO,58874,58874,0,8385,8385,0,602.13476
20/03/2023 10:46,2022,1,WESTERN EUROPE-EU,ITALY,2,MANCHESTER,TURIN,22742,9833,12909,1460,420,1040,1457.67123
20/03/2023 10:46,2022,1,WESTERN EUROPE-EU,ITALY,2,MANCHESTER,VENICE,96446,96446,0,4394,4286,108,2094.94766
20/03/2023 10:46,2022,1,WESTERN EUROPE-EU,ITALY,2,MANCHESTER,VERONA VILLAFRANCA,58235,36137,22098,3147,2646,501,1750.49253
20/03/2023 10:46,2022,1,WESTERN EUROPE-EU,ITALY,2,NEWCASTLE,BERGAMO,24081,24081,0,0,0,0,0
20/03/2023 10:46,2022,1,WESTERN EUROPE-EU,ITALY,2,NEWCASTLE,NAPLES,16776,16776,0,0,0,0,0
20/03/2023 10:46,2022,1,WESTERN EUROPE-EU,ITALY,2,NEWCASTLE,PARMA,82,0,82,0,0,0,0
20/03/2023 10:46,2022,1,WESTERN EUROPE-EU,ITALY,2,NEWCASTLE,ROME (FIUMICINO),21023,21023,0,0,0,0,0
20/03/2023 10:46,2022,1,WESTERN EUROPE-EU,ITALY,2,NEWCASTLE,TURIN,4200,4200,0,255,255,0,1547.05882
20/03/2023 10:46,2022,1,WESTERN EUROPE-EU,ITALY,2,NEWCASTLE,VERONA VILLAFRANCA,13950,13950,0,0,0,0,0
20/03/2023 10:46,2022,1,WESTERN EUROPE-EU,ITALY,2,NEWQUAY,BERGAMO,340,0,340,0,0,0,0
20/03/2023 10:46,2022,1,WESTERN EUROPE-EU,ITALY,2,NORWICH,BERGAMO,365,0,365,0,0,0,0
20/03/2023 10:46,2022,1,WESTERN EUROPE-EU,ITALY,2,OXFORD (KIDLINGTON),BERGAMO,0,0,0,50,50,0,-100
20/03/2023 10:46,2022,1,WESTERN EUROPE-EU,ITALY,2,OXFORD (KIDLINGTON),BOLOGNA,120,120,0,308,308,0,-61.03896
20/03/2023 10:46,2022,1,WESTERN EUROPE-EU,ITALY,2,PRESTWICK,BERGAMO,9,0,9,0,0,0,0
20/03/2023 10:46,2022,1,WESTERN EUROPE-EU,ITALY,2,SOUTHAMPTON,FLORENCE,456,456,0,0,0,0,0
20/03/2023 10:46,2022,1,WESTERN EUROPE-EU,ITALY,2,TEESSIDE INTERNATIONAL AIRPORT,BERGAMO,367,0,367,0,0,0,0
20/03/2023 10:46,2022,1,WESTERN EUROPE-EU,LUXEMBOURG,1,GATWICK,LUXEMBOURG,5932,5932,0,0,0,0,0
20/03/2023 10:46,2022,1,WESTERN EUROPE-EU,LUXEMBOURG,1,HEATHROW,LUXEMBOURG,48858,48858,0,7878,7878,0,520.18279
20/03/2023 10:46,2022,1,WESTERN EUROPE-EU,LUXEMBOURG,1,LONDON CITY,LUXEMBOURG,181670,181670,0,23598,23598,0,669.85338
20/03/2023 10:46,2022,1,WESTERN EUROPE-EU,LUXEMBOURG,1,LUTON,LUXEMBOURG,227,177,50,0,0,0,0
20/03/2023 10:46,2022,1,WESTERN EUROPE-EU,LUXEMBOURG,1,STANSTED,LUXEMBOURG,92596,92596,0,27374,27276,98,238.26258
20/03/2023 10:46,2022,1,WESTERN EUROPE-EU,LUXEMBOURG,2,BELFAST INTERNATIONAL,LUXEMBOURG,108,0,108,166,0,166,-34.93976
20/03/2023 10:46,2022,1,WESTERN EUROPE-EU,LUXEMBOURG,2,BIGGIN HILL,LUXEMBOURG,0,0,0,2,0,2,-100
20/03/2023 10:46,2022,1,WESTERN EUROPE-EU,LUXEMBOURG,2,BIRMINGHAM,LUXEMBOURG,42,0,42,41,0,41,2.43902
20/03/2023 10:46,2022,1,WESTERN EUROPE-EU,LUXEMBOURG,2,BOURNEMOUTH,LUXEMBOURG,0,0,0,45,45,0,-100
20/03/2023 10:46,2022,1,WESTERN EUROPE-EU,LUXEMBOURG,2,GLASGOW,LUXEMBOURG,0,0,0,47,0,47,-100
20/03/2023 10:46,2022,1,WESTERN EUROPE-EU,MALTA,1,GATWICK,MALTA,294968,279006,15962,65142,64006,1136,352.80771
20/03/2023 10:46,2022,1,WESTERN EUROPE-EU,MALTA,1,HEATHROW,MALTA,216299,216299,0,123237,122505,732,75.51466
20/03/2023 10:46,2022,1,WESTERN EUROPE-EU,MALTA,1,LUTON,MALTA,67506,67506,0,48621,48621,0,38.84124
20/03/2023 10:46,2022,1,WESTERN EUROPE-EU,MALTA,1,SOUTHEND,MALTA,261,261,0,0,0,0,0
20/03/2023 10:46,2022,1,WESTERN EUROPE-EU,MALTA,1,STANSTED,MALTA,105634,105481,153,50448,50448,0,109.39185
20/03/2023 10:46,2022,1,WESTERN EUROPE-EU,MALTA,2,ABERDEEN,MALTA,0,0,0,89,0,89,-100
20/03/2023 10:46,2022,1,WESTERN EUROPE-EU,MALTA,2,BIGGIN HILL,MALTA,0,0,0,96,0,96,-100
20/03/2023 10:46,2022,1,WESTERN EUROPE-EU,MALTA,2,BIRMINGHAM,MALTA,64212,54501,9711,29005,29005,0,121.38252
20/03/2023 10:46,2022,1,WESTERN EUROPE-EU,MALTA,2,BOURNEMOUTH,MALTA,14475,14475,0,6846,6846,0,111.43734
20/03/2023 10:46,2022,1,WESTERN EUROPE-EU,MALTA,2,BRISTOL,MALTA,17360,8372,8988,8428,8428,0,105.98007
20/03/2023 10:46,2022,1,WESTERN EUROPE-EU,MALTA,2,EAST MIDLANDS INTERNATIONAL,MALTA,11684,11684,0,10159,10159,0,15.01132
20/03/2023 10:46,2022,1,WESTERN EUROPE-EU,MALTA,2,EDINBURGH,MALTA,35044,35044,0,16402,16402,0,113.65687
20/03/2023 10:46,2022,1,WESTERN EUROPE-EU,MALTA,2,GLASGOW,MALTA,10205,10205,0,4164,4164,0,145.07685
20/03/2023 10:46,2022,1,WESTERN EUROPE-EU,MALTA,2,LEEDS BRADFORD,MALTA,8835,8835,0,13373,13373,0,-33.93405
20/03/2023 10:46,2022,1,WESTERN EUROPE-EU,MALTA,2,LIVERPOOL (JOHN LENNON),MALTA,9342,9342,0,15627,15627,0,-40.21885
20/03/2023 10:46,2022,1,WESTERN EUROPE-EU,MALTA,2,MANCHESTER,MALTA,199287,179637,19650,83327,82229,1098,139.16258
20/03/2023 10:46,2022,1,WESTERN EUROPE-EU,MALTA,2,NEWCASTLE,MALTA,10295,10239,56,9059,9059,0,13.64389
20/03/2023 10:46,2022,1,WESTERN EUROPE-EU,NETHERLANDS,1,GATWICK,AMSTERDAM,605141,605141,0,51462,51459,3,1075.89872
20/03/2023 10:46,2022,1,WESTERN EUROPE-EU,NETHERLANDS,1,HEATHROW,AMSTERDAM,1143986,1143986,0,350659,350659,0,226.23888
20/03/2023 10:46,2022,1,WESTERN EUROPE-EU,NETHERLANDS,1,LONDON CITY,AMSTERDAM,393748,393748,0,81750,81750,0,381.64893
20/03/2023 10:46,2022,1,WESTERN EUROPE-EU,NETHERLANDS,1,LONDON CITY,ROTTERDAM,111282,111282,0,6407,6407,0,1636.88154
20/03/2023 10:46,2022,1,WESTERN EUROPE-EU,NETHERLANDS,1,LUTON,AMSTERDAM,414313,414313,0,51422,51422,0,705.71156
20/03/2023 10:46,2022,1,WESTERN EUROPE-EU,NETHERLANDS,1,SOUTHEND,AMSTERDAM,61,0,61,0,0,0,0
20/03/2023 10:46,2022,1,WESTERN EUROPE-EU,NETHERLANDS,1,STANSTED,AMSTERDAM,124671,124671,0,24611,24604,7,406.56617
20/03/2023 10:46,2022,1,WESTERN EUROPE-EU,NETHERLANDS,1,STANSTED,EINDHOVEN,308211,308211,0,41667,41667,0,639.70048
20/03/2023 10:46,2022,1,WESTERN EUROPE-EU,NETHERLANDS,1,STANSTED,MAASTRICHT,23047,23047,0,48,0,48,47914.58333
20/03/2023 10:46,2022,1,WESTERN EUROPE-EU,NETHERLANDS,2,ABERDEEN,AMSTERDAM,212731,212731,0,92243,92152,91,130.62021
20/03/2023 10:46,2022,1,WESTERN EUROPE-EU,NETHERLANDS,2,ABERDEEN,MAASTRICHT,80,0,80,0,0,0,0
20/03/2023 10:46,2022,1,WESTERN EUROPE-EU,NETHERLANDS,2,ABERDEEN,ROTTERDAM,0,0,0,34,0,34,-100
20/03/2023 10:46,2022,1,WESTERN EUROPE-EU,NETHERLANDS,2,BELFAST CITY (GEORGE BEST),AMSTERDAM,52055,52055,0,16398,16398,0,217.44725
20/03/2023 10:46,2022,1,WESTERN EUROPE-EU,NETHERLANDS,2,BELFAST INTERNATIONAL,AMSTERDAM,71155,70798,357,4341,4341,0,1539.13845
20/03/2023 10:46,2022,1,WESTERN EUROPE-EU,NETHERLANDS,2,BIGGIN HILL,AMSTERDAM,20,0,20,6,0,6,233.33333
20/03/2023 10:46,2022,1,WESTERN EUROPE-EU,NETHERLANDS,2,BIGGIN HILL,ROTTERDAM,31,0,31,0,0,0,0
20/03/2023 10:46,2022,1,WESTERN EUROPE-EU,NETHERLANDS,2,BIRMINGHAM,AMSTERDAM,431304,431304,0,124565,124563,2,246.24814
20/03/2023 10:46,2022,1,WESTERN EUROPE-EU,NETHERLANDS,2,BRISTOL,AMSTERDAM,349096,349096,0,60318,60318,0,478.75924
20/03/2023 10:46,2022,1,WESTERN EUROPE-EU,NETHERLANDS,2,CARDIFF WALES,AMSTERDAM,62734,62544,190,11426,11331,95,449.04604
20/03/2023 10:46,2022,1,WESTERN EUROPE-EU,NETHERLANDS,2,CARDIFF WALES,GRONINGEN,143,0,143,0,0,0,0
20/03/2023 10:46,2022,1,WESTERN EUROPE-EU,NETHERLANDS,2,CARDIFF WALES,ROTTERDAM,259,0,259,0,0,0,0
20/03/2023 10:46,2022,1,WESTERN EUROPE-EU,NETHERLANDS,2,EAST MIDLANDS INTERNATIONAL,AMSTERDAM,24615,24615,0,0,0,0,0
20/03/2023 10:46,2022,1,WESTERN EUROPE-EU,NETHERLANDS,2,EAST MIDLANDS INTERNATIONAL,EINDHOVEN,158,0,158,0,0,0,0
20/03/2023 10:46,2022,1,WESTERN EUROPE-EU,NETHERLANDS,2,EDINBURGH,AMSTERDAM,471698,471698,0,131437,131437,0,258.87764
20/03/2023 10:46,2022,1,WESTERN EUROPE-EU,NETHERLANDS,2,EDINBURGH,EINDHOVEN,28629,28253,376,2306,2306,0,1141.50043
20/03/2023 10:46,2022,1,WESTERN EUROPE-EU,NETHERLANDS,2,EDINBURGH,ROTTERDAM,27439,27439,0,0,0,0,0
20/03/2023 10:46,2022,1,WESTERN EUROPE-EU,NETHERLANDS,2,GLASGOW,AMSTERDAM,339390,338491,899,96971,96764,207,249.99123
20/03/2023 10:46,2022,1,WESTERN EUROPE-EU,NETHERLANDS,2,GLASGOW,EINDHOVEN,596,0,596,0,0,0,0
20/03/2023 10:46,2022,1,WESTERN EUROPE-EU,NETHERLANDS,2,GUERNSEY,AMSTERDAM,0,0,0,199,198,1,-100
20/03/2023 10:46,2022,1,WESTERN EUROPE-EU,NETHERLANDS,2,GUERNSEY,GRONINGEN,1979,1979,0,0,0,0,0
20/03/2023 10:46,2022,1,WESTERN EUROPE-EU,NETHERLANDS,2,GUERNSEY,ROTTERDAM,1443,1443,0,0,0,0,0
20/03/2023 10:46,2022,1,WESTERN EUROPE-EU,NETHERLANDS,2,HUMBERSIDE,AMSTERDAM,47843,47716,127,5752,5726,26,731.76287
20/03/2023 10:46,2022,1,WESTERN EUROPE-EU,NETHERLANDS,2,INVERNESS,AMSTERDAM,48786,48786,0,10757,10757,0,353.52794
20/03/2023 10:46,2022,1,WESTERN EUROPE-EU,NETHERLANDS,2,INVERNESS,EINDHOVEN,636,0,636,0,0,0,0
20/03/2023 10:46,2022,1,WESTERN EUROPE-EU,NETHERLANDS,2,JERSEY,ROTTERDAM,268,0,268,0,0,0,0
20/03/2023 10:46,2022,1,WESTERN EUROPE-EU,NETHERLANDS,2,LEEDS BRADFORD,AMSTERDAM,133962,133890,72,38472,38472,0,248.20649
20/03/2023 10:46,2022,1,WESTERN EUROPE-EU,NETHERLANDS,2,LIVERPOOL (JOHN LENNON),AMSTERDAM,143256,142376,880,10709,10709,0,1237.71594
20/03/2023 10:46,2022,1,WESTERN EUROPE-EU,NETHERLANDS,2,LIVERPOOL (JOHN LENNON),EINDHOVEN,0,0,0,43,0,43,-100
20/03/2023 10:46,2022,1,WESTERN EUROPE-EU,NETHERLANDS,2,LIVERPOOL (JOHN LENNON),MAASTRICHT,85,0,85,0,0,0,0
20/03/2023 10:46,2022,1,WESTERN EUROPE-EU,NETHERLANDS,2,LIVERPOOL (JOHN LENNON),ROTTERDAM,245,0,245,0,0,0,0
20/03/2023 10:46,2022,1,WESTERN EUROPE-EU,NETHERLANDS,2,MANCHESTER,AMSTERDAM,704217,704029,188,225591,225591,0,212.16538
20/03/2023 10:46,2022,1,WESTERN EUROPE-EU,NETHERLANDS,2,MANCHESTER,EINDHOVEN,45915,45915,0,5939,5939,0,673.10995
20/03/2023 10:46,2022,1,WESTERN EUROPE-EU,NETHERLANDS,2,MANCHESTER,MAASTRICHT,69,0,69,0,0,0,0
20/03/2023 10:46,2022,1,WESTERN EUROPE-EU,NETHERLANDS,2,MANCHESTER,ROTTERDAM,176,0,176,0,0,0,0
20/03/2023 10:46,2022,1,WESTERN EUROPE-EU,NETHERLANDS,2,NEWCASTLE,AMSTERDAM,255437,255437,0,95024,95024,0,168.81314
20/03/2023 10:46,2022,1,WESTERN EUROPE-EU,NETHERLANDS,2,NORWICH,AMSTERDAM,71147,71147,0,9850,9850,0,622.30457
20/03/2023 10:46,2022,1,WESTERN EUROPE-EU,NETHERLANDS,2,NORWICH,GRONINGEN,879,879,0,0,0,0,0
20/03/2023 10:46,2022,1,WESTERN EUROPE-EU,NETHERLANDS,2,SOUTHAMPTON,AMSTERDAM,52779,52683,96,9401,9401,0,461.419
20/03/2023 10:46,2022,1,WESTERN EUROPE-EU,NETHERLANDS,2,TEESSIDE INTERNATIONAL AIRPORT,AMSTERDAM,42789,42789,0,3860,3860,0,1008.52332
20/03/2023 10:46,2022,1,WESTERN EUROPE-EU,NETHERLANDS,2,TEESSIDE INTERNATIONAL AIRPORT,EINDHOVEN,79,0,79,0,0,0,0
20/03/2023 10:46,2022,1,WESTERN EUROPE-EU,PORTUGAL(EXCLUDING MADEIRA),1,GATWICK,AZORES LAJES TERCEIRA ISLAND,250,0,250,0,0,0,0
20/03/2023 10:46,2022,1,WESTERN EUROPE-EU,PORTUGAL(EXCLUDING MADEIRA),1,GATWICK,FARO,626800,606249,20551,147279,135361,11918,325.58681
20/03/2023 10:46,2022,1,WESTERN EUROPE-EU,PORTUGAL(EXCLUDING MADEIRA),1,GATWICK,LISBON,407060,407060,0,79064,78979,85,414.84873
20/03/2023 10:46,2022,1,WESTERN EUROPE-EU,PORTUGAL(EXCLUDING MADEIRA),1,GATWICK,OPORTO (PORTUGAL),275577,275577,0,72964,68325,4639,277.689
20/03/2023 10:46,2022,1,WESTERN EUROPE-EU,PORTUGAL(EXCLUDING MADEIRA),1,HEATHROW,AZORES LAJES TERCEIRA ISLAND,939,939,0,0,0,0,0
20/03/2023 10:46,2022,1,WESTERN EUROPE-EU,PORTUGAL(EXCLUDING MADEIRA),1,HEATHROW,AZORES PONTA DELGADA,2232,2232,0,0,0,0,0
20/03/2023 10:46,2022,1,WESTERN EUROPE-EU,PORTUGAL(EXCLUDING MADEIRA),1,HEATHROW,FARO,161224,161224,0,128455,128062,393,25.5101
20/03/2023 10:46,2022,1,WESTERN EUROPE-EU,PORTUGAL(EXCLUDING MADEIRA),1,HEATHROW,LISBON,912824,912824,0,300798,300798,0,203.46744
20/03/2023 10:46,2022,1,WESTERN EUROPE-EU,PORTUGAL(EXCLUDING MADEIRA),1,HEATHROW,OPORTO (PORTUGAL),137636,137636,0,23706,23536,170,480.59563
20/03/2023 10:46,2022,1,WESTERN EUROPE-EU,PORTUGAL(EXCLUDING MADEIRA),1,LONDON CITY,FARO,9351,9351,0,4675,4675,0,100.02139
20/03/2023 10:46,2022,1,WESTERN EUROPE-EU,PORTUGAL(EXCLUDING MADEIRA),1,LUTON,AZORES PONTA DELGADA,0,0,0,206,206,0,-100
20/03/2023 10:46,2022,1,WESTERN EUROPE-EU,PORTUGAL(EXCLUDING MADEIRA),1,LUTON,FARO,239198,239198,0,91770,91604,166,160.64945
20/03/2023 10:46,2022,1,WESTERN EUROPE-EU,PORTUGAL(EXCLUDING MADEIRA),1,LUTON,LISBON,287378,287378,0,79409,79409,0,261.89601
20/03/2023 10:46,2022,1,WESTERN EUROPE-EU,PORTUGAL(EXCLUDING MADEIRA),1,LUTON,OPORTO (PORTUGAL),100492,100492,0,21306,21258,48,371.66057
20/03/2023 10:46,2022,1,WESTERN EUROPE-EU,PORTUGAL(EXCLUDING MADEIRA),1,SOUTHEND,FARO,16600,16600,0,5141,5141,0,222.89438
20/03/2023 10:46,2022,1,WESTERN EUROPE-EU,PORTUGAL(EXCLUDING MADEIRA),1,STANSTED,AZORES LAJES TERCEIRA ISLAND,5589,5589,0,0,0,0,0
20/03/2023 10:46,2022,1,WESTERN EUROPE-EU,PORTUGAL(EXCLUDING MADEIRA),1,STANSTED,AZORES PONTA DELGADA,12252,12252,0,6533,6533,0,87.54018
20/03/2023 10:46,2022,1,WESTERN EUROPE-EU,PORTUGAL(EXCLUDING MADEIRA),1,STANSTED,FARO,380778,380692,86,134232,133707,525,183.67155
20/03/2023 10:46,2022,1,WESTERN EUROPE-EU,PORTUGAL(EXCLUDING MADEIRA),1,STANSTED,LISBON,436069,436069,0,188263,188263,0,131.62756
20/03/2023 10:46,2022,1,WESTERN EUROPE-EU,PORTUGAL(EXCLUDING MADEIRA),1,STANSTED,OPORTO (PORTUGAL),337183,337183,0,130214,130214,0,158.94527
20/03/2023 10:46,2022,1,WESTERN EUROPE-EU,PORTUGAL(EXCLUDING MADEIRA),2,ABERDEEN,FARO,19852,19852,0,2095,2095,0,847.5895
20/03/2023 10:46,2022,1,WESTERN EUROPE-EU,PORTUGAL(EXCLUDING MADEIRA),2,ABERDEEN,OPORTO (PORTUGAL),189,189,0,0,0,0,0
20/03/2023 10:46,2022,1,WESTERN EUROPE-EU,PORTUGAL(EXCLUDING MADEIRA),2,BELFAST CITY (GEORGE BEST),FARO,0,0,0,6757,6757,0,-100
20/03/2023 10:46,2022,1,WESTERN EUROPE-EU,PORTUGAL(EXCLUDING MADEIRA),2,BELFAST INTERNATIONAL,FARO,164327,164322,5,30276,30276,0,442.76324
20/03/2023 10:46,2022,1,WESTERN EUROPE-EU,PORTUGAL(EXCLUDING MADEIRA),2,BELFAST INTERNATIONAL,LISBON,22,0,22,0,0,0,0
20/03/2023 10:46,2022,1,WESTERN EUROPE-EU,PORTUGAL(EXCLUDING MADEIRA),2,BELFAST INTERNATIONAL,OPORTO (PORTUGAL),0,0,0,176,0,176,-100
20/03/2023 10:46,2022,1,WESTERN EUROPE-EU,PORTUGAL(EXCLUDING MADEIRA),2,BIGGIN HILL,BEJA ,58,0,58,0,0,0,0
20/03/2023 10:46,2022,1,WESTERN EUROPE-EU,PORTUGAL(EXCLUDING MADEIRA),2,BIGGIN HILL,CASCAIS,1,0,1,0,0,0,0
20/03/2023 10:46,2022,1,WESTERN EUROPE-EU,PORTUGAL(EXCLUDING MADEIRA),2,BIGGIN HILL,FARO,181,0,181,63,0,63,187.30159
20/03/2023 10:46,2022,1,WESTERN EUROPE-EU,PORTUGAL(EXCLUDING MADEIRA),2,BIGGIN HILL,LISBON,60,0,60,3,0,3,1900
20/03/2023 10:46,2022,1,WESTERN EUROPE-EU,PORTUGAL(EXCLUDING MADEIRA),2,BIGGIN HILL,OPORTO (PORTUGAL),2,0,2,0,0,0,0
20/03/2023 10:46,2022,1,WESTERN EUROPE-EU,PORTUGAL(EXCLUDING MADEIRA),2,BIRMINGHAM,FARO,254281,235512,18769,69519,65151,4368,265.77195
20/03/2023 10:46,2022,1,WESTERN EUROPE-EU,PORTUGAL(EXCLUDING MADEIRA),2,BIRMINGHAM,LISBON,18983,18936,47,4771,4771,0,297.88304
20/03/2023 10:46,2022,1,WESTERN EUROPE-EU,PORTUGAL(EXCLUDING MADEIRA),2,BIRMINGHAM,OPORTO (PORTUGAL),30800,30800,0,13027,13027,0,136.43203
20/03/2023 10:46,2022,1,WESTERN EUROPE-EU,PORTUGAL(EXCLUDING MADEIRA),2,BOURNEMOUTH,FARO,50890,50834,56,16519,16519,0,208.0695
20/03/2023 10:46,2022,1,WESTERN EUROPE-EU,PORTUGAL(EXCLUDING MADEIRA),2,BOURNEMOUTH,LISBON,3944,3944,0,2605,2605,0,51.40115
20/03/2023 10:46,2022,1,WESTERN EUROPE-EU,PORTUGAL(EXCLUDING MADEIRA),2,BRISTOL,FARO,290858,290858,0,75460,73539,1921,285.44659
20/03/2023 10:46,2022,1,WESTERN EUROPE-EU,PORTUGAL(EXCLUDING MADEIRA),2,BRISTOL,LISBON,74690,74690,0,18764,18764,0,298.04946
20/03/2023 10:46,2022,1,WESTERN EUROPE-EU,PORTUGAL(EXCLUDING MADEIRA),2,BRISTOL,OPORTO (PORTUGAL),39706,39706,0,12213,12213,0,225.11258
20/03/2023 10:46,2022,1,WESTERN EUROPE-EU,PORTUGAL(EXCLUDING MADEIRA),2,CARDIFF WALES,FARO,36494,36449,45,3433,3134,299,963.03525
20/03/2023 10:46,2022,1,WESTERN EUROPE-EU,PORTUGAL(EXCLUDING MADEIRA),2,CITY OF DERRY (EGLINTON),FARO,1776,0,1776,0,0,0,0
20/03/2023 10:46,2022,1,WESTERN EUROPE-EU,PORTUGAL(EXCLUDING MADEIRA),2,DONCASTER SHEFFIELD,FARO,17403,0,17403,1044,1044,0,1566.95402
20/03/2023 10:46,2022,1,WESTERN EUROPE-EU,PORTUGAL(EXCLUDING MADEIRA),2,DONCASTER SHEFFIELD,LISBON,101,0,101,0,0,0,0
20/03/2023 10:46,2022,1,WESTERN EUROPE-EU,PORTUGAL(EXCLUDING MADEIRA),2,DUNDEE,FARO,8,0,8,4,0,4,100
20/03/2023 10:46,2022,1,WESTERN EUROPE-EU,PORTUGAL(EXCLUDING MADEIRA),2,EAST MIDLANDS INTERNATIONAL,FARO,221169,203329,17840,52376,48234,4142,322.27165
20/03/2023 10:46,2022,1,WESTERN EUROPE-EU,PORTUGAL(EXCLUDING MADEIRA),2,EAST MIDLANDS INTERNATIONAL,LISBON,258,258,0,0,0,0,0
20/03/2023 10:46,2022,1,WESTERN EUROPE-EU,PORTUGAL(EXCLUDING MADEIRA),2,EDINBURGH,FARO,145505,145505,0,28279,28279,0,414.53375
20/03/2023 10:46,2022,1,WESTERN EUROPE-EU,PORTUGAL(EXCLUDING MADEIRA),2,EDINBURGH,LISBON,90544,90544,0,23942,23942,0,278.1806
20/03/2023 10:46,2022,1,WESTERN EUROPE-EU,PORTUGAL(EXCLUDING MADEIRA),2,EDINBURGH,OPORTO (PORTUGAL),42019,42019,0,10063,10007,56,317.55938
20/03/2023 10:46,2022,1,WESTERN EUROPE-EU,PORTUGAL(EXCLUDING MADEIRA),2,EXETER,FARO,0,0,0,126,126,0,-100
20/03/2023 10:46,2022,1,WESTERN EUROPE-EU,PORTUGAL(EXCLUDING MADEIRA),2,GLASGOW,FARO,112774,111289,1485,19760,19760,0,470.71862
20/03/2023 10:46,2022,1,WESTERN EUROPE-EU,PORTUGAL(EXCLUDING MADEIRA),2,GLASGOW,LISBON,0,0,0,338,0,338,-100
20/03/2023 10:46,2022,1,WESTERN EUROPE-EU,PORTUGAL(EXCLUDING MADEIRA),2,GLASGOW,OPORTO (PORTUGAL),2510,0,2510,0,0,0,0
20/03/2023 10:46,2022,1,WESTERN EUROPE-EU,PORTUGAL(EXCLUDING MADEIRA),2,GUERNSEY,OPORTO (PORTUGAL),126,126,0,0,0,0,0
20/03/2023 10:46,2022,1,WESTERN EUROPE-EU,PORTUGAL(EXCLUDING MADEIRA),2,LEEDS BRADFORD,FARO,162984,162984,0,42282,42282,0,285.46899
20/03/2023 10:46,2022,1,WESTERN EUROPE-EU,PORTUGAL(EXCLUDING MADEIRA),2,LIVERPOOL (JOHN LENNON),FARO,141824,141824,0,56431,56431,0,151.32285
20/03/2023 10:46,2022,1,WESTERN EUROPE-EU,PORTUGAL(EXCLUDING MADEIRA),2,LIVERPOOL (JOHN LENNON),LISBON,1342,76,1266,0,0,0,0
20/03/2023 10:46,2022,1,WESTERN EUROPE-EU,PORTUGAL(EXCLUDING MADEIRA),2,LIVERPOOL (JOHN LENNON),OPORTO (PORTUGAL),19869,19869,0,5280,4874,406,276.30682
20/03/2023 10:46,2022,1,WESTERN EUROPE-EU,PORTUGAL(EXCLUDING MADEIRA),2,MANCHESTER,AZORES PONTA DELGADA,4698,4698,0,0,0,0,0
20/03/2023 10:46,2022,1,WESTERN EUROPE-EU,PORTUGAL(EXCLUDING MADEIRA),2,MANCHESTER,FARO,458714,439162,19552,138991,125721,13270,230.03144
20/03/2023 10:46,2022,1,WESTERN EUROPE-EU,PORTUGAL(EXCLUDING MADEIRA),2,MANCHESTER,LISBON,253325,252520,805,95074,95074,0,166.45034
20/03/2023 10:46,2022,1,WESTERN EUROPE-EU,PORTUGAL(EXCLUDING MADEIRA),2,MANCHESTER,OPORTO (PORTUGAL),94067,94067,0,40107,31299,8808,134.54011
20/03/2023 10:46,2022,1,WESTERN EUROPE-EU,PORTUGAL(EXCLUDING MADEIRA),2,NEWCASTLE,FARO,140034,140034,0,28688,28688,0,388.12744
20/03/2023 10:46,2022,1,WESTERN EUROPE-EU,PORTUGAL(EXCLUDING MADEIRA),2,NEWQUAY,FARO,20382,20382,0,5342,5342,0,281.54249
20/03/2023 10:46,2022,1,WESTERN EUROPE-EU,PORTUGAL(EXCLUDING MADEIRA),2,PRESTWICK,FARO,51661,51661,0,7167,7167,0,620.81764
20/03/2023 10:46,2022,1,WESTERN EUROPE-EU,PORTUGAL(EXCLUDING MADEIRA),2,PRESTWICK,OPORTO (PORTUGAL),179,0,179,0,0,0,0
20/03/2023 10:46,2022,1,WESTERN EUROPE-EU,PORTUGAL(EXCLUDING MADEIRA),2,SOUTHAMPTON,FARO,3911,3911,0,1864,1864,0,109.8176
20/03/2023 10:46,2022,1,WESTERN EUROPE-EU,PORTUGAL(EXCLUDING MADEIRA),2,TEESSIDE INTERNATIONAL AIRPORT,FARO,19146,19146,0,3911,3911,0,389.54232
20/03/2023 10:46,2022,1,WESTERN EUROPE-EU,PORTUGAL(MADEIRA),1,GATWICK,FUNCHAL,194923,194923,0,87208,74472,12736,123.51504
20/03/2023 10:46,2022,1,WESTERN EUROPE-EU,PORTUGAL(MADEIRA),1,GATWICK,PORTO SANTO,9154,0,9154,6018,118,5900,52.11034
20/03/2023 10:46,2022,1,WESTERN EUROPE-EU,PORTUGAL(MADEIRA),1,HEATHROW,FUNCHAL,89646,89646,0,56534,56534,0,58.57006
20/03/2023 10:46,2022,1,WESTERN EUROPE-EU,PORTUGAL(MADEIRA),1,LUTON,FUNCHAL,30894,30894,0,18673,18673,0,65.44744
20/03/2023 10:46,2022,1,WESTERN EUROPE-EU,PORTUGAL(MADEIRA),1,STANSTED,FUNCHAL,105596,105596,0,19479,19479,0,442.10175
20/03/2023 10:46,2022,1,WESTERN EUROPE-EU,PORTUGAL(MADEIRA),2,BIRMINGHAM,FUNCHAL,46969,23881,23088,19874,13497,6377,136.3339
20/03/2023 10:46,2022,1,WESTERN EUROPE-EU,PORTUGAL(MADEIRA),2,BRISTOL,FUNCHAL,49801,49801,0,21717,21717,0,129.31805
20/03/2023 10:46,2022,1,WESTERN EUROPE-EU,PORTUGAL(MADEIRA),2,CARDIFF WALES,FUNCHAL,135,135,0,0,0,0,0
20/03/2023 10:46,2022,1,WESTERN EUROPE-EU,PORTUGAL(MADEIRA),2,EAST MIDLANDS INTERNATIONAL,FUNCHAL,15844,15844,0,6549,6549,0,141.93007
20/03/2023 10:46,2022,1,WESTERN EUROPE-EU,PORTUGAL(MADEIRA),2,EDINBURGH,FUNCHAL,17080,17080,0,7245,7245,0,135.74879
20/03/2023 10:46,2022,1,WESTERN EUROPE-EU,PORTUGAL(MADEIRA),2,GLASGOW,FUNCHAL,14319,14319,0,6442,6442,0,122.27569
20/03/2023 10:46,2022,1,WESTERN EUROPE-EU,PORTUGAL(MADEIRA),2,GLASGOW,PORTO SANTO,0,0,0,177,177,0,-100
20/03/2023 10:46,2022,1,WESTERN EUROPE-EU,PORTUGAL(MADEIRA),2,JERSEY,FUNCHAL,6804,0,6804,5399,0,5399,26.02334
20/03/2023 10:46,2022,1,WESTERN EUROPE-EU,PORTUGAL(MADEIRA),2,LEEDS BRADFORD,FUNCHAL,17544,17544,0,11074,11074,0,58.42514
20/03/2023 10:46,2022,1,WESTERN EUROPE-EU,PORTUGAL(MADEIRA),2,MANCHESTER,FUNCHAL,127210,100296,26914,50097,31705,18392,153.92738
20/03/2023 10:46,2022,1,WESTERN EUROPE-EU,PORTUGAL(MADEIRA),2,MANCHESTER,PORTO SANTO,7285,0,7285,4046,0,4046,80.05437
20/03/2023 10:46,2022,1,WESTERN EUROPE-EU,PORTUGAL(MADEIRA),2,NEWCASTLE,FUNCHAL,15267,15267,0,6042,6042,0,152.68123
20/03/2023 10:46,2022,1,WESTERN EUROPE-EU,SLOVENIA,1,GATWICK,LJUBLJANA,58292,58292,0,9200,9200,0,533.6087
20/03/2023 10:46,2022,1,WESTERN EUROPE-EU,SLOVENIA,1,HEATHROW,LJUBLJANA,29430,29430,0,8717,8717,0,237.61615
20/03/2023 10:46,2022,1,WESTERN EUROPE-EU,SLOVENIA,1,LUTON,LJUBLJANA,33616,33616,0,1425,1425,0,2259.01754
20/03/2023 10:46,2022,1,WESTERN EUROPE-EU,SLOVENIA,1,STANSTED,LJUBLJANA,10,0,10,67,0,67,-85.07463
20/03/2023 10:46,2022,1,WESTERN EUROPE-EU,SLOVENIA,1,STANSTED,MARIBOR,0,0,0,100,0,100,-100
20/03/2023 10:46,2022,1,WESTERN EUROPE-EU,SLOVENIA,2,BIGGIN HILL,LJUBLJANA,0,0,0,10,0,10,-100
20/03/2023 10:46,2022,1,WESTERN EUROPE-EU,SLOVENIA,2,CARDIFF WALES,MARIBOR,0,0,0,91,0,91,-100
20/03/2023 10:46,2022,1,WESTERN EUROPE-EU,SLOVENIA,2,GLASGOW,LJUBLJANA,51,0,51,0,0,0,0
20/03/2023 10:46,2022,1,WESTERN EUROPE-EU,SLOVENIA,2,PRESTWICK,LJUBLJANA,87,0,87,0,0,0,0
20/03/2023 10:46,2022,1,WESTERN EUROPE-EU,SPAIN,1,GATWICK,A CORUNA,36850,36850,0,0,0,0,0
20/03/2023 10:46,2022,1,WESTERN EUROPE-EU,SPAIN,1,GATWICK,ALICANTE,577717,556872,20845,170002,169576,426,239.82953
20/03/2023 10:46,2022,1,WESTERN EUROPE-EU,SPAIN,1,GATWICK,ALMERIA,95832,95832,0,19801,19801,0,383.97556
20/03/2023 10:46,2022,1,WESTERN EUROPE-EU,SPAIN,1,GATWICK,ASTURIAS,41649,41649,0,1182,823,359,3423.60406
20/03/2023 10:46,2022,1,WESTERN EUROPE-EU,SPAIN,1,GATWICK,BARCELONA,1006584,1004554,2030,172593,172205,388,483.21253
20/03/2023 10:46,2022,1,WESTERN EUROPE-EU,SPAIN,1,GATWICK,BILBAO,250500,250500,0,29751,29751,0,741.9885
20/03/2023 10:46,2022,1,WESTERN EUROPE-EU,SPAIN,1,GATWICK,GIRONA,13085,0,13085,0,0,0,0
20/03/2023 10:46,2022,1,WESTERN EUROPE-EU,SPAIN,1,GATWICK,GRANADA,28770,28770,0,0,0,0,0
20/03/2023 10:46,2022,1,WESTERN EUROPE-EU,SPAIN,1,GATWICK,IBIZA,206111,154832,51279,66583,48639,17944,209.55499
20/03/2023 10:46,2022,1,WESTERN EUROPE-EU,SPAIN,1,GATWICK,JEREZ,16951,8383,8568,0,0,0,0
20/03/2023 10:46,2022,1,WESTERN EUROPE-EU,SPAIN,1,GATWICK,MADRID,632257,632257,0,144165,143701,464,338.56484
20/03/2023 10:46,2022,1,WESTERN EUROPE-EU,SPAIN,1,GATWICK,MAHON,229605,195683,33922,54980,44417,10563,317.6155
20/03/2023 10:46,2022,1,WESTERN EUROPE-EU,SPAIN,1,GATWICK,MALAGA,879306,848500,30806,145676,138690,6986,503.60389
20/03/2023 10:46,2022,1,WESTERN EUROPE-EU,SPAIN,1,GATWICK,MURCIA INTERNATIONAL,163647,163647,0,44759,44759,0,265.61809
20/03/2023 10:46,2022,1,WESTERN EUROPE-EU,SPAIN,1,GATWICK,PALMA DE MALLORCA,626301,526188,100113,152286,121177,31109,311.2663
20/03/2023 10:46,2022,1,WESTERN EUROPE-EU,SPAIN,1,GATWICK,REUS,22042,0,22042,849,0,849,2496.23086
20/03/2023 10:46,2022,1,WESTERN EUROPE-EU,SPAIN,1,GATWICK,SANTIAGO DE COMPOSTELA (SPAIN),68148,68148,0,13947,13947,0,388.62121
20/03/2023 10:46,2022,1,WESTERN EUROPE-EU,SPAIN,1,GATWICK,SEVILLE,236774,236774,0,15147,15090,57,1463.17423
20/03/2023 10:46,2022,1,WESTERN EUROPE-EU,SPAIN,1,GATWICK,VALENCIA,285984,285984,0,45771,45771,0,524.81484
20/03/2023 10:46,2022,1,WESTERN EUROPE-EU,SPAIN,1,HEATHROW,ALICANTE,0,0,0,38509,38509,0,-100
20/03/2023 10:46,2022,1,WESTERN EUROPE-EU,SPAIN,1,HEATHROW,BARCELONA,557224,557224,0,170837,170837,0,226.1729
20/03/2023 10:46,2022,1,WESTERN EUROPE-EU,SPAIN,1,HEATHROW,BILBAO,3381,3381,0,7784,7784,0,-56.56475
20/03/2023 10:46,2022,1,WESTERN EUROPE-EU,SPAIN,1,HEATHROW,IBIZA,115317,115317,0,97874,97874,0,17.82189
20/03/2023 10:46,2022,1,WESTERN EUROPE-EU,SPAIN,1,HEATHROW,MADRID,1185456,1185456,0,425759,425650,109,178.43357
20/03/2023 10:46,2022,1,WESTERN EUROPE-EU,SPAIN,1,HEATHROW,MAHON,0,0,0,16466,16466,0,-100
20/03/2023 10:46,2022,1,WESTERN EUROPE-EU,SPAIN,1,HEATHROW,MALAGA,263779,263779,0,168817,168636,181,56.25144
20/03/2023 10:46,2022,1,WESTERN EUROPE-EU,SPAIN,1,HEATHROW,PALMA DE MALLORCA,169897,169897,0,128802,128722,80,31.90556
20/03/2023 10:46,2022,1,WESTERN EUROPE-EU,SPAIN,1,HEATHROW,SEVILLE,16898,16898,0,13859,13726,133,21.92799
20/03/2023 10:46,2022,1,WESTERN EUROPE-EU,SPAIN,1,HEATHROW,VALENCIA,93145,93145,0,21591,21225,366,331.4066
20/03/2023 10:46,2022,1,WESTERN EUROPE-EU,SPAIN,1,LONDON CITY,BARCELONA,18272,18272,0,0,0,0,0
20/03/2023 10:46,2022,1,WESTERN EUROPE-EU,SPAIN,1,LONDON CITY,IBIZA,95320,95320,0,36026,36026,0,164.58669
20/03/2023 10:46,2022,1,WESTERN EUROPE-EU,SPAIN,1,LONDON CITY,MAHON,4684,4684,0,3088,3088,0,51.68394
20/03/2023 10:46,2022,1,WESTERN EUROPE-EU,SPAIN,1,LONDON CITY,MALAGA,53508,53508,0,24512,24512,0,118.29308
20/03/2023 10:46,2022,1,WESTERN EUROPE-EU,SPAIN,1,LONDON CITY,PALMA DE MALLORCA,49390,49390,0,21921,21826,95,125.30906
20/03/2023 10:46,2022,1,WESTERN EUROPE-EU,SPAIN,1,LONDON CITY,SAN SEBASTIAN,2473,2473,0,0,0,0,0
20/03/2023 10:46,2022,1,WESTERN EUROPE-EU,SPAIN,1,LUTON,ALICANTE,241554,241554,0,84662,84662,0,185.31573
20/03/2023 10:46,2022,1,WESTERN EUROPE-EU,SPAIN,1,LUTON,ALMERIA,158,158,0,0,0,0,0
20/03/2023 10:46,2022,1,WESTERN EUROPE-EU,SPAIN,1,LUTON,BARCELONA,220602,220602,0,32528,32353,175,578.1911
20/03/2023 10:46,2022,1,WESTERN EUROPE-EU,SPAIN,1,LUTON,CASTELLON COSTA AZAHAR,8237,8237,0,0,0,0,0
20/03/2023 10:46,2022,1,WESTERN EUROPE-EU,SPAIN,1,LUTON,GIRONA,178,0,178,4945,4945,0,-96.4004
20/03/2023 10:46,2022,1,WESTERN EUROPE-EU,SPAIN,1,LUTON,IBIZA,60253,59528,725,17276,17276,0,248.76708
20/03/2023 10:46,2022,1,WESTERN EUROPE-EU,SPAIN,1,LUTON,MADRID,6033,5836,197,308,68,240,1858.76623
20/03/2023 10:46,2022,1,WESTERN EUROPE-EU,SPAIN,1,LUTON,MAHON,32829,32829,0,12853,12853,0,155.41897
20/03/2023 10:46,2022,1,WESTERN EUROPE-EU,SPAIN,1,LUTON,MALAGA,381189,381189,0,127885,127885,0,198.07171
20/03/2023 10:46,2022,1,WESTERN EUROPE-EU,SPAIN,1,LUTON,MURCIA INTERNATIONAL,48552,48552,0,0,0,0,0
20/03/2023 10:46,2022,1,WESTERN EUROPE-EU,SPAIN,1,LUTON,PALMA DE MALLORCA,295609,270622,24987,94056,87752,6304,214.29042
20/03/2023 10:46,2022,1,WESTERN EUROPE-EU,SPAIN,1,LUTON,SEVILLE,29483,29425,58,4090,4090,0,620.85575
20/03/2023 10:46,2022,1,WESTERN EUROPE-EU,SPAIN,1,LUTON,VALENCIA,77,77,0,0,0,0,0
20/03/2023 10:46,2022,1,WESTERN EUROPE-EU,SPAIN,1,SOUTHEND,ALICANTE,0,0,0,19819,19819,0,-100
20/03/2023 10:46,2022,1,WESTERN EUROPE-EU,SPAIN,1,SOUTHEND,MALAGA,42487,42487,0,19235,19235,0,120.88381
20/03/2023 10:46,2022,1,WESTERN EUROPE-EU,SPAIN,1,SOUTHEND,PALMA DE MALLORCA,28231,28227,4,21446,21446,0,31.6376
20/03/2023 10:46,2022,1,WESTERN EUROPE-EU,SPAIN,1,SOUTHEND,REUS,0,0,0,1375,1375,0,-100
20/03/2023 10:46,2022,1,WESTERN EUROPE-EU,SPAIN,1,STANSTED,ALICANTE,372451,372451,0,139874,139874,0,166.27608
20/03/2023 10:46,2022,1,WESTERN EUROPE-EU,SPAIN,1,STANSTED,ALMERIA,30116,30116,0,10068,10068,0,199.12594
20/03/2023 10:46,2022,1,WESTERN EUROPE-EU,SPAIN,1,STANSTED,ASTURIAS,6551,6551,0,0,0,0,0
20/03/2023 10:46,2022,1,WESTERN EUROPE-EU,SPAIN,1,STANSTED,BARCELONA,435732,435732,0,147468,147215,253,195.47563
20/03/2023 10:46,2022,1,WESTERN EUROPE-EU,SPAIN,1,STANSTED,BILBAO,96,96,0,0,0,0,0
20/03/2023 10:46,2022,1,WESTERN EUROPE-EU,SPAIN,1,STANSTED,CASTELLON COSTA AZAHAR,33686,33686,0,13291,13291,0,153.4497
20/03/2023 10:46,2022,1,WESTERN EUROPE-EU,SPAIN,1,STANSTED,GIRONA,101897,101897,0,18490,18406,84,451.09248
20/03/2023 10:46,2022,1,WESTERN EUROPE-EU,SPAIN,1,STANSTED,IBIZA,216641,201554,15087,72583,67585,4998,198.47347
20/03/2023 10:46,2022,1,WESTERN EUROPE-EU,SPAIN,1,STANSTED,JEREZ,30432,30432,0,10949,10949,0,177.94319
20/03/2023 10:46,2022,1,WESTERN EUROPE-EU,SPAIN,1,STANSTED,MADRID,370521,370376,145,143938,143887,51,157.41708
20/03/2023 10:46,2022,1,WESTERN EUROPE-EU,SPAIN,1,STANSTED,MAHON,101261,84937,16324,16509,14819,1690,513.36847
20/03/2023 10:46,2022,1,WESTERN EUROPE-EU,SPAIN,1,STANSTED,MALAGA,341438,341438,0,119131,119131,0,186.60718
20/03/2023 10:46,2022,1,WESTERN EUROPE-EU,SPAIN,1,STANSTED,MURCIA INTERNATIONAL,97768,97768,0,0,0,0,0
20/03/2023 10:46,2022,1,WESTERN EUROPE-EU,SPAIN,1,STANSTED,PALMA DE MALLORCA,387592,355177,32415,131164,122051,9113,195.50181
20/03/2023 10:46,2022,1,WESTERN EUROPE-EU,SPAIN,1,STANSTED,REUS,59406,59406,0,9664,9664,0,514.7144
20/03/2023 10:46,2022,1,WESTERN EUROPE-EU,SPAIN,1,STANSTED,SANTANDER,73321,73321,0,28266,28266,0,159.39645
20/03/2023 10:46,2022,1,WESTERN EUROPE-EU,SPAIN,1,STANSTED,SANTIAGO DE COMPOSTELA (SPAIN),110540,110540,0,37772,37772,0,192.65064
20/03/2023 10:46,2022,1,WESTERN EUROPE-EU,SPAIN,1,STANSTED,SEVILLE,146633,146261,372,58802,58802,0,149.36737
20/03/2023 10:46,2022,1,WESTERN EUROPE-EU,SPAIN,1,STANSTED,VALENCIA,174284,174115,169,61464,61464,0,183.5546
20/03/2023 10:46,2022,1,WESTERN EUROPE-EU,SPAIN,1,STANSTED,ZARAGOZA,70882,70882,0,20468,20468,0,246.30643
20/03/2023 10:46,2022,1,WESTERN EUROPE-EU,SPAIN,2,ABERDEEN,ALICANTE,31848,31848,0,10343,10343,0,207.9184
20/03/2023 10:46,2022,1,WESTERN EUROPE-EU,SPAIN,2,ABERDEEN,MALAGA,20545,20545,0,5270,5270,0,289.8482
20/03/2023 10:46,2022,1,WESTERN EUROPE-EU,SPAIN,2,ABERDEEN,PALMA DE MALLORCA,26617,0,26617,2258,0,2258,1078.78654
20/03/2023 10:46,2022,1,WESTERN EUROPE-EU,SPAIN,2,ABERDEEN,REUS,8488,0,8488,0,0,0,0
20/03/2023 10:46,2022,1,WESTERN EUROPE-EU,SPAIN,2,ABERDEEN,SANTIAGO DE COMPOSTELA (SPAIN),193,193,0,0,0,0,0
20/03/2023 10:46,2022,1,WESTERN EUROPE-EU,SPAIN,2,BELFAST CITY (GEORGE BEST),ALICANTE,0,0,0,11296,11296,0,-100
20/03/2023 10:46,2022,1,WESTERN EUROPE-EU,SPAIN,2,BELFAST CITY (GEORGE BEST),BARCELONA,1774,0,1774,5460,5460,0,-67.50916
20/03/2023 10:46,2022,1,WESTERN EUROPE-EU,SPAIN,2,BELFAST CITY (GEORGE BEST),IBIZA,0,0,0,746,746,0,-100
20/03/2023 10:46,2022,1,WESTERN EUROPE-EU,SPAIN,2,BELFAST CITY (GEORGE BEST),MALAGA,0,0,0,8044,8044,0,-100
20/03/2023 10:46,2022,1,WESTERN EUROPE-EU,SPAIN,2,BELFAST CITY (GEORGE BEST),PALMA DE MALLORCA,1307,0,1307,8288,8288,0,-84.23021
20/03/2023 10:46,2022,1,WESTERN EUROPE-EU,SPAIN,2,BELFAST CITY (GEORGE BEST),VALENCIA,0,0,0,953,889,64,-100
20/03/2023 10:46,2022,1,WESTERN EUROPE-EU,SPAIN,2,BELFAST INTERNATIONAL,ALICANTE,158838,158838,0,37912,37912,0,318.96497
20/03/2023 10:46,2022,1,WESTERN EUROPE-EU,SPAIN,2,BELFAST INTERNATIONAL,BARCELONA,37599,37434,165,0,0,0,0
20/03/2023 10:46,2022,1,WESTERN EUROPE-EU,SPAIN,2,BELFAST INTERNATIONAL,IBIZA,43490,36632,6858,8376,8369,7,419.22159
20/03/2023 10:46,2022,1,WESTERN EUROPE-EU,SPAIN,2,BELFAST INTERNATIONAL,MADRID,87,0,87,0,0,0,0
20/03/2023 10:46,2022,1,WESTERN EUROPE-EU,SPAIN,2,BELFAST INTERNATIONAL,MAHON,21250,21250,0,1097,1097,0,1837.10119
20/03/2023 10:46,2022,1,WESTERN EUROPE-EU,SPAIN,2,BELFAST INTERNATIONAL,MALAGA,156021,148536,7485,32448,32425,23,380.83395
20/03/2023 10:46,2022,1,WESTERN EUROPE-EU,SPAIN,2,BELFAST INTERNATIONAL,PALMA DE MALLORCA,174538,153445,21093,23362,21722,1640,647.10213
20/03/2023 10:46,2022,1,WESTERN EUROPE-EU,SPAIN,2,BELFAST INTERNATIONAL,REUS,40244,26800,13444,0,0,0,0
20/03/2023 10:46,2022,1,WESTERN EUROPE-EU,SPAIN,2,BELFAST INTERNATIONAL,SEVILLE,0,0,0,180,180,0,-100
20/03/2023 10:46,2022,1,WESTERN EUROPE-EU,SPAIN,2,BELFAST INTERNATIONAL,VALENCIA,0,0,0,2017,0,2017,-100
20/03/2023 10:46,2022,1,WESTERN EUROPE-EU,SPAIN,2,BIGGIN HILL,ALICANTE,0,0,0,5,0,5,-100
20/03/2023 10:46,2022,1,WESTERN EUROPE-EU,SPAIN,2,BIGGIN HILL,BARCELONA,11,0,11,6,0,6,83.33333
20/03/2023 10:46,2022,1,WESTERN EUROPE-EU,SPAIN,2,BIGGIN HILL,BILBAO,2,0,2,0,0,0,0
20/03/2023 10:46,2022,1,WESTERN EUROPE-EU,SPAIN,2,BIGGIN HILL,GIRONA,3,0,3,5,0,5,-40
20/03/2023 10:46,2022,1,WESTERN EUROPE-EU,SPAIN,2,BIGGIN HILL,GRANADA,8,0,8,0,0,0,0
20/03/2023 10:46,2022,1,WESTERN EUROPE-EU,SPAIN,2,BIGGIN HILL,IBIZA,65,0,65,208,0,208,-68.75
20/03/2023 10:46,2022,1,WESTERN EUROPE-EU,SPAIN,2,BIGGIN HILL,MADRID,15,0,15,12,0,12,25
20/03/2023 10:46,2022,1,WESTERN EUROPE-EU,SPAIN,2,BIGGIN HILL,MAHON,37,0,37,54,0,54,-31.48148
20/03/2023 10:46,2022,1,WESTERN EUROPE-EU,SPAIN,2,BIGGIN HILL,MALAGA,72,0,72,81,0,81,-11.11111
20/03/2023 10:46,2022,1,WESTERN EUROPE-EU,SPAIN,2,BIGGIN HILL,PALMA DE MALLORCA,59,0,59,48,0,48,22.91667
20/03/2023 10:46,2022,1,WESTERN EUROPE-EU,SPAIN,2,BIGGIN HILL,SEVILLE,4,0,4,0,0,0,0
20/03/2023 10:46,2022,1,WESTERN EUROPE-EU,SPAIN,2,BIGGIN HILL,VALENCIA,73,0,73,0,0,0,0
20/03/2023 10:46,2022,1,WESTERN EUROPE-EU,SPAIN,2,BIRMINGHAM,ALICANTE,330423,305412,25011,92463,92463,0,257.357
20/03/2023 10:46,2022,1,WESTERN EUROPE-EU,SPAIN,2,BIRMINGHAM,ALMERIA,33239,20090,13149,3438,3438,0,866.8121
20/03/2023 10:46,2022,1,WESTERN EUROPE-EU,SPAIN,2,BIRMINGHAM,BARCELONA,201371,199886,1485,46583,46091,492,332.28431
20/03/2023 10:46,2022,1,WESTERN EUROPE-EU,SPAIN,2,BIRMINGHAM,BILBAO,101,101,0,0,0,0,0
20/03/2023 10:46,2022,1,WESTERN EUROPE-EU,SPAIN,2,BIRMINGHAM,GIRONA,27495,16521,10974,0,0,0,0
20/03/2023 10:46,2022,1,WESTERN EUROPE-EU,SPAIN,2,BIRMINGHAM,IBIZA,129256,90756,38500,38964,25667,13297,231.73186
20/03/2023 10:46,2022,1,WESTERN EUROPE-EU,SPAIN,2,BIRMINGHAM,MADRID,34549,34318,231,14476,14476,0,138.664
20/03/2023 10:46,2022,1,WESTERN EUROPE-EU,SPAIN,2,BIRMINGHAM,MAHON,72244,39421,32823,18684,13139,5545,286.66238
20/03/2023 10:46,2022,1,WESTERN EUROPE-EU,SPAIN,2,BIRMINGHAM,MALAGA,293957,267687,26270,82629,75796,6833,255.75524
20/03/2023 10:46,2022,1,WESTERN EUROPE-EU,SPAIN,2,BIRMINGHAM,MURCIA INTERNATIONAL,32893,32893,0,21760,21760,0,51.16268
20/03/2023 10:46,2022,1,WESTERN EUROPE-EU,SPAIN,2,BIRMINGHAM,PALMA DE MALLORCA,357627,263638,93989,79786,63842,15944,348.23277
20/03/2023 10:46,2022,1,WESTERN EUROPE-EU,SPAIN,2,BIRMINGHAM,REUS,61926,41272,20654,4365,4365,0,1318.69416
20/03/2023 10:46,2022,1,WESTERN EUROPE-EU,SPAIN,2,BIRMINGHAM,SANTANDER,4236,4236,0,0,0,0,0
20/03/2023 10:46,2022,1,WESTERN EUROPE-EU,SPAIN,2,BIRMINGHAM,SANTIAGO DE COMPOSTELA (SPAIN),76,76,0,0,0,0,0
20/03/2023 10:46,2022,1,WESTERN EUROPE-EU,SPAIN,2,BIRMINGHAM,VALENCIA,0,0,0,130,59,71,-100
20/03/2023 10:46,2022,1,WESTERN EUROPE-EU,SPAIN,2,BIRMINGHAM,VIGO,0,0,0,83,0,83,-100
20/03/2023 10:46,2022,1,WESTERN EUROPE-EU,SPAIN,2,BOURNEMOUTH,ALICANTE,70195,70195,0,20789,20789,0,237.65453
20/03/2023 10:46,2022,1,WESTERN EUROPE-EU,SPAIN,2,BOURNEMOUTH,GIRONA,35907,35907,0,6771,6771,0,430.30572
20/03/2023 10:46,2022,1,WESTERN EUROPE-EU,SPAIN,2,BOURNEMOUTH,IBIZA,6246,0,6246,0,0,0,0
20/03/2023 10:46,2022,1,WESTERN EUROPE-EU,SPAIN,2,BOURNEMOUTH,MAHON,8298,0,8298,0,0,0,0
20/03/2023 10:46,2022,1,WESTERN EUROPE-EU,SPAIN,2,BOURNEMOUTH,MALAGA,67418,67354,64,21560,21508,52,212.69944
20/03/2023 10:46,2022,1,WESTERN EUROPE-EU,SPAIN,2,BOURNEMOUTH,MURCIA INTERNATIONAL,29233,29233,0,8244,8244,0,254.59728
20/03/2023 10:46,2022,1,WESTERN EUROPE-EU,SPAIN,2,BOURNEMOUTH,PALMA DE MALLORCA,110968,72754,38214,21745,15125,6620,410.31501
20/03/2023 10:46,2022,1,WESTERN EUROPE-EU,SPAIN,2,BOURNEMOUTH,VITORIA,96,0,96,0,0,0,0
20/03/2023 10:46,2022,1,WESTERN EUROPE-EU,SPAIN,2,BRISTOL,ALICANTE,361324,361324,0,90704,90704,0,298.35509
20/03/2023 10:46,2022,1,WESTERN EUROPE-EU,SPAIN,2,BRISTOL,ALMERIA,7140,7140,0,0,0,0,0
20/03/2023 10:46,2022,1,WESTERN EUROPE-EU,SPAIN,2,BRISTOL,BARCELONA,201072,201072,0,22224,22224,0,804.75162
20/03/2023 10:46,2022,1,WESTERN EUROPE-EU,SPAIN,2,BRISTOL,BILBAO,17928,17928,0,2626,2626,0,582.71135
20/03/2023 10:46,2022,1,WESTERN EUROPE-EU,SPAIN,2,BRISTOL,GIRONA,58154,58154,0,4467,4467,0,1201.85807
20/03/2023 10:46,2022,1,WESTERN EUROPE-EU,SPAIN,2,BRISTOL,IBIZA,117315,83994,33321,30888,20899,9989,279.80769
20/03/2023 10:46,2022,1,WESTERN EUROPE-EU,SPAIN,2,BRISTOL,MADRID,105337,105337,0,22983,22983,0,358.32572
20/03/2023 10:46,2022,1,WESTERN EUROPE-EU,SPAIN,2,BRISTOL,MAHON,66322,48684,17638,14027,12506,1521,372.81671
20/03/2023 10:46,2022,1,WESTERN EUROPE-EU,SPAIN,2,BRISTOL,MALAGA,316799,299669,17130,79447,79447,0,298.75514
20/03/2023 10:46,2022,1,WESTERN EUROPE-EU,SPAIN,2,BRISTOL,MURCIA INTERNATIONAL,51715,51715,0,14842,14842,0,248.43687
20/03/2023 10:46,2022,1,WESTERN EUROPE-EU,SPAIN,2,BRISTOL,PALMA DE MALLORCA,350929,308608,42321,101963,89671,12292,244.17289
20/03/2023 10:46,2022,1,WESTERN EUROPE-EU,SPAIN,2,BRISTOL,REUS,28972,15368,13604,0,0,0,0
20/03/2023 10:46,2022,1,WESTERN EUROPE-EU,SPAIN,2,BRISTOL,SEVILLE,4443,4443,0,3656,3656,0,21.52626
20/03/2023 10:46,2022,1,WESTERN EUROPE-EU,SPAIN,2,BRISTOL,VALENCIA,28702,28702,0,9174,9135,39,212.86244
20/03/2023 10:46,2022,1,WESTERN EUROPE-EU,SPAIN,2,CARDIFF WALES,ALICANTE,107645,76610,31035,18208,14697,3511,491.19618
20/03/2023 10:46,2022,1,WESTERN EUROPE-EU,SPAIN,2,CARDIFF WALES,BARCELONA,0,0,0,1790,1790,0,-100
20/03/2023 10:46,2022,1,WESTERN EUROPE-EU,SPAIN,2,CARDIFF WALES,IBIZA,15473,54,15419,955,0,955,1520.20942
20/03/2023 10:46,2022,1,WESTERN EUROPE-EU,SPAIN,2,CARDIFF WALES,MADRID,0,0,0,64,0,64,-100
20/03/2023 10:46,2022,1,WESTERN EUROPE-EU,SPAIN,2,CARDIFF WALES,MAHON,15382,0,15382,0,0,0,0
20/03/2023 10:46,2022,1,WESTERN EUROPE-EU,SPAIN,2,CARDIFF WALES,MALAGA,63102,41290,21812,13141,11767,1374,380.19177
20/03/2023 10:46,2022,1,WESTERN EUROPE-EU,SPAIN,2,CARDIFF WALES,MURCIA INTERNATIONAL,90,0,90,0,0,0,0
20/03/2023 10:46,2022,1,WESTERN EUROPE-EU,SPAIN,2,CARDIFF WALES,PALMA DE MALLORCA,73843,29380,44463,11589,4009,7580,537.18181
20/03/2023 10:46,2022,1,WESTERN EUROPE-EU,SPAIN,2,CARDIFF WALES,REUS,6085,0,6085,0,0,0,0
20/03/2023 10:46,2022,1,WESTERN EUROPE-EU,SPAIN,2,CITY OF DERRY (EGLINTON),PALMA DE MALLORCA,2644,0,2644,0,0,0,0
20/03/2023 10:46,2022,1,WESTERN EUROPE-EU,SPAIN,2,DONCASTER SHEFFIELD,ALICANTE,35176,5445,29731,13931,5676,8255,152.50162
20/03/2023 10:46,2022,1,WESTERN EUROPE-EU,SPAIN,2,DONCASTER SHEFFIELD,GIRONA,4517,0,4517,0,0,0,0
20/03/2023 10:46,2022,1,WESTERN EUROPE-EU,SPAIN,2,DONCASTER SHEFFIELD,IBIZA,17299,0,17299,1842,0,1842,839.14224
20/03/2023 10:46,2022,1,WESTERN EUROPE-EU,SPAIN,2,DONCASTER SHEFFIELD,MAHON,17259,0,17259,1071,0,1071,1511.48459
20/03/2023 10:46,2022,1,WESTERN EUROPE-EU,SPAIN,2,DONCASTER SHEFFIELD,MALAGA,39416,5250,34166,4764,0,4764,727.37196
20/03/2023 10:46,2022,1,WESTERN EUROPE-EU,SPAIN,2,DONCASTER SHEFFIELD,PALMA DE MALLORCA,59546,2989,56557,14433,0,14433,312.56842
20/03/2023 10:46,2022,1,WESTERN EUROPE-EU,SPAIN,2,DONCASTER SHEFFIELD,REUS,13661,0,13661,0,0,0,0
20/03/2023 10:46,2022,1,WESTERN EUROPE-EU,SPAIN,2,DUNDEE,MALAGA,0,0,0,2,0,2,-100
20/03/2023 10:46,2022,1,WESTERN EUROPE-EU,SPAIN,2,DUNDEE,ZARAGOZA,5,0,5,0,0,0,0
20/03/2023 10:46,2022,1,WESTERN EUROPE-EU,SPAIN,2,EAST MIDLANDS INTERNATIONAL,ALICANTE,309549,281973,27576,79454,76528,2926,289.59524
20/03/2023 10:46,2022,1,WESTERN EUROPE-EU,SPAIN,2,EAST MIDLANDS INTERNATIONAL,BARCELONA,71950,71871,79,17060,17060,0,321.74678
20/03/2023 10:46,2022,1,WESTERN EUROPE-EU,SPAIN,2,EAST MIDLANDS INTERNATIONAL,GIRONA,7375,7375,0,1969,1969,0,274.55561
20/03/2023 10:46,2022,1,WESTERN EUROPE-EU,SPAIN,2,EAST MIDLANDS INTERNATIONAL,IBIZA,57035,39263,17772,21006,13289,7717,171.51766
20/03/2023 10:46,2022,1,WESTERN EUROPE-EU,SPAIN,2,EAST MIDLANDS INTERNATIONAL,JEREZ,0,0,0,163,0,163,-100
20/03/2023 10:46,2022,1,WESTERN EUROPE-EU,SPAIN,2,EAST MIDLANDS INTERNATIONAL,MADRID,169,169,0,0,0,0,0
20/03/2023 10:46,2022,1,WESTERN EUROPE-EU,SPAIN,2,EAST MIDLANDS INTERNATIONAL,MAHON,55350,39837,15513,11293,11293,0,390.12663
20/03/2023 10:46,2022,1,WESTERN EUROPE-EU,SPAIN,2,EAST MIDLANDS INTERNATIONAL,MALAGA,245052,220572,24480,58974,58830,144,315.52549
20/03/2023 10:46,2022,1,WESTERN EUROPE-EU,SPAIN,2,EAST MIDLANDS INTERNATIONAL,MURCIA INTERNATIONAL,45829,45829,0,0,0,0,0
20/03/2023 10:46,2022,1,WESTERN EUROPE-EU,SPAIN,2,EAST MIDLANDS INTERNATIONAL,PALMA DE MALLORCA,257701,225101,32600,67734,56777,10957,280.46033
20/03/2023 10:46,2022,1,WESTERN EUROPE-EU,SPAIN,2,EAST MIDLANDS INTERNATIONAL,REUS,33515,33515,0,1692,1692,0,1880.79196
20/03/2023 10:46,2022,1,WESTERN EUROPE-EU,SPAIN,2,EAST MIDLANDS INTERNATIONAL,SANTIAGO DE COMPOSTELA (SPAIN),184,0,184,0,0,0,0
20/03/2023 10:46,2022,1,WESTERN EUROPE-EU,SPAIN,2,EAST MIDLANDS INTERNATIONAL,VALENCIA,19886,19886,0,7809,7809,0,154.65489
20/03/2023 10:46,2022,1,WESTERN EUROPE-EU,SPAIN,2,EDINBURGH,ALICANTE,210523,210523,0,43648,43648,0,382.31992
20/03/2023 10:46,2022,1,WESTERN EUROPE-EU,SPAIN,2,EDINBURGH,BARCELONA,179948,179948,0,36188,36188,0,397.25876
20/03/2023 10:46,2022,1,WESTERN EUROPE-EU,SPAIN,2,EDINBURGH,GIRONA,0,0,0,1401,1401,0,-100
20/03/2023 10:46,2022,1,WESTERN EUROPE-EU,SPAIN,2,EDINBURGH,IBIZA,49330,49330,0,6761,6761,0,629.6258
20/03/2023 10:46,2022,1,WESTERN EUROPE-EU,SPAIN,2,EDINBURGH,LIEIDA,0,0,0,80,0,80,-100
20/03/2023 10:46,2022,1,WESTERN EUROPE-EU,SPAIN,2,EDINBURGH,MADRID,144702,144607,95,23765,23705,60,508.88702
20/03/2023 10:46,2022,1,WESTERN EUROPE-EU,SPAIN,2,EDINBURGH,MAHON,11974,8809,3165,2578,2578,0,364.46858
20/03/2023 10:46,2022,1,WESTERN EUROPE-EU,SPAIN,2,EDINBURGH,MALAGA,170871,170871,0,32791,32791,0,421.09115
20/03/2023 10:46,2022,1,WESTERN EUROPE-EU,SPAIN,2,EDINBURGH,PALMA DE MALLORCA,190095,170905,19190,38660,38660,0,391.70978
20/03/2023 10:46,2022,1,WESTERN EUROPE-EU,SPAIN,2,EDINBURGH,PAMPLONA,346,0,346,0,0,0,0
20/03/2023 10:46,2022,1,WESTERN EUROPE-EU,SPAIN,2,EDINBURGH,REUS,18077,18077,0,0,0,0,0
20/03/2023 10:46,2022,1,WESTERN EUROPE-EU,SPAIN,2,EDINBURGH,SANTANDER,30246,30246,0,8610,8610,0,251.2892
20/03/2023 10:46,2022,1,WESTERN EUROPE-EU,SPAIN,2,EDINBURGH,SANTIAGO DE COMPOSTELA (SPAIN),24113,24113,0,0,0,0,0
20/03/2023 10:46,2022,1,WESTERN EUROPE-EU,SPAIN,2,EDINBURGH,SEVILLE,33800,33800,0,9260,9174,86,265.0108
20/03/2023 10:46,2022,1,WESTERN EUROPE-EU,SPAIN,2,EDINBURGH,VALENCIA,26646,26646,0,2871,2871,0,828.10867
20/03/2023 10:46,2022,1,WESTERN EUROPE-EU,SPAIN,2,EDINBURGH,VITORIA,335,0,335,0,0,0,0
20/03/2023 10:46,2022,1,WESTERN EUROPE-EU,SPAIN,2,EXETER,ALICANTE,25025,25025,0,8076,8076,0,209.86875
20/03/2023 10:46,2022,1,WESTERN EUROPE-EU,SPAIN,2,EXETER,IBIZA,5943,0,5943,0,0,0,0
20/03/2023 10:46,2022,1,WESTERN EUROPE-EU,SPAIN,2,EXETER,MAHON,15677,0,15677,0,0,0,0
20/03/2023 10:46,2022,1,WESTERN EUROPE-EU,SPAIN,2,EXETER,MALAGA,19100,19100,0,7074,7074,0,170.00283
20/03/2023 10:46,2022,1,WESTERN EUROPE-EU,SPAIN,2,EXETER,PALMA DE MALLORCA,33234,0,33234,3746,0,3746,787.18633
20/03/2023 10:46,2022,1,WESTERN EUROPE-EU,SPAIN,2,GLASGOW,ALICANTE,235421,213761,21660,46575,44805,1770,405.46645
20/03/2023 10:46,2022,1,WESTERN EUROPE-EU,SPAIN,2,GLASGOW,BARCELONA,32037,28392,3645,0,0,0,0
20/03/2023 10:46,2022,1,WESTERN EUROPE-EU,SPAIN,2,GLASGOW,IBIZA,58665,41932,16733,11912,11122,790,392.48657
20/03/2023 10:46,2022,1,WESTERN EUROPE-EU,SPAIN,2,GLASGOW,JEREZ,1302,0,1302,0,0,0,0
20/03/2023 10:46,2022,1,WESTERN EUROPE-EU,SPAIN,2,GLASGOW,MADRID,3099,0,3099,115,0,115,2594.78261
20/03/2023 10:46,2022,1,WESTERN EUROPE-EU,SPAIN,2,GLASGOW,MAHON,18179,14923,3256,2224,2224,0,717.40108
20/03/2023 10:46,2022,1,WESTERN EUROPE-EU,SPAIN,2,GLASGOW,MALAGA,206775,191410,15365,42830,40659,2171,382.78076
20/03/2023 10:46,2022,1,WESTERN EUROPE-EU,SPAIN,2,GLASGOW,PALMA DE MALLORCA,161044,112241,48803,25837,23390,2447,523.30766
20/03/2023 10:46,2022,1,WESTERN EUROPE-EU,SPAIN,2,GLASGOW,REUS,48410,23705,24705,0,0,0,0
20/03/2023 10:46,2022,1,WESTERN EUROPE-EU,SPAIN,2,GLASGOW,SEVILLE,5740,1136,4604,241,0,241,2281.74274
20/03/2023 10:46,2022,1,WESTERN EUROPE-EU,SPAIN,2,GUERNSEY,BARCELONA,270,270,0,121,121,0,123.1405
20/03/2023 10:46,2022,1,WESTERN EUROPE-EU,SPAIN,2,GUERNSEY,BILBAO,117,117,0,0,0,0,0
20/03/2023 10:46,2022,1,WESTERN EUROPE-EU,SPAIN,2,GUERNSEY,IBIZA,109,109,0,72,0,72,51.38889
20/03/2023 10:46,2022,1,WESTERN EUROPE-EU,SPAIN,2,GUERNSEY,MADRID,119,119,0,0,0,0,0
20/03/2023 10:46,2022,1,WESTERN EUROPE-EU,SPAIN,2,GUERNSEY,MALAGA,1271,1271,0,306,0,306,315.35948
20/03/2023 10:46,2022,1,WESTERN EUROPE-EU,SPAIN,2,GUERNSEY,PALMA DE MALLORCA,3269,3269,0,838,107,731,290.09547
20/03/2023 10:46,2022,1,WESTERN EUROPE-EU,SPAIN,2,GUERNSEY,REUS,110,110,0,0,0,0,0
20/03/2023 10:46,2022,1,WESTERN EUROPE-EU,SPAIN,2,HUMBERSIDE,PALMA DE MALLORCA,8874,0,8874,1,0,1,887300
20/03/2023 10:46,2022,1,WESTERN EUROPE-EU,SPAIN,2,INVERNESS,MADRID,56,0,56,0,0,0,0
20/03/2023 10:46,2022,1,WESTERN EUROPE-EU,SPAIN,2,INVERNESS,PALMA DE MALLORCA,2708,1200,1508,0,0,0,0
20/03/2023 10:46,2022,1,WESTERN EUROPE-EU,SPAIN,2,INVERNESS,SEVILLE,10,0,10,0,0,0,0
20/03/2023 10:46,2022,1,WESTERN EUROPE-EU,SPAIN,2,ISLE OF MAN,PALMA DE MALLORCA,2893,0,2893,0,0,0,0
20/03/2023 10:46,2022,1,WESTERN EUROPE-EU,SPAIN,2,JERSEY,BARCELONA,187,0,187,120,0,120,55.83333
20/03/2023 10:46,2022,1,WESTERN EUROPE-EU,SPAIN,2,JERSEY,IBIZA,441,441,0,602,602,0,-26.74419
20/03/2023 10:46,2022,1,WESTERN EUROPE-EU,SPAIN,2,JERSEY,MALAGA,2103,0,2103,1339,69,1270,57.05751
20/03/2023 10:46,2022,1,WESTERN EUROPE-EU,SPAIN,2,JERSEY,PALMA DE MALLORCA,5015,0,5015,4409,0,4409,13.74461
20/03/2023 10:46,2022,1,WESTERN EUROPE-EU,SPAIN,2,JERSEY,REUS,402,0,402,0,0,0,0
20/03/2023 10:46,2022,1,WESTERN EUROPE-EU,SPAIN,2,LEEDS BRADFORD,ALICANTE,272750,272750,0,63269,63269,0,331.0958
20/03/2023 10:46,2022,1,WESTERN EUROPE-EU,SPAIN,2,LEEDS BRADFORD,ALMERIA,6713,6713,0,0,0,0,0
20/03/2023 10:46,2022,1,WESTERN EUROPE-EU,SPAIN,2,LEEDS BRADFORD,BARCELONA,24321,23650,671,0,0,0,0
20/03/2023 10:46,2022,1,WESTERN EUROPE-EU,SPAIN,2,LEEDS BRADFORD,GIRONA,48814,48814,0,0,0,0,0
20/03/2023 10:46,2022,1,WESTERN EUROPE-EU,SPAIN,2,LEEDS BRADFORD,IBIZA,85538,85538,0,19236,19236,0,344.67665
20/03/2023 10:46,2022,1,WESTERN EUROPE-EU,SPAIN,2,LEEDS BRADFORD,MAHON,31381,31381,0,12316,12316,0,154.79864
20/03/2023 10:46,2022,1,WESTERN EUROPE-EU,SPAIN,2,LEEDS BRADFORD,MALAGA,234517,234517,0,53506,53506,0,338.30038
20/03/2023 10:46,2022,1,WESTERN EUROPE-EU,SPAIN,2,LEEDS BRADFORD,PALMA DE MALLORCA,239965,221538,18427,56845,56696,149,322.13915
20/03/2023 10:46,2022,1,WESTERN EUROPE-EU,SPAIN,2,LEEDS BRADFORD,REUS,47311,47311,0,0,0,0,0
20/03/2023 10:46,2022,1,WESTERN EUROPE-EU,SPAIN,2,LEEDS BRADFORD,SAN SEBASTIAN,120,0,120,0,0,0,0
20/03/2023 10:46,2022,1,WESTERN EUROPE-EU,SPAIN,2,LEEDS BRADFORD,VALENCIA,103,50,53,88,0,88,17.04545
20/03/2023 10:46,2022,1,WESTERN EUROPE-EU,SPAIN,2,LIVERPOOL (JOHN LENNON),ALICANTE,192050,192050,0,72856,72856,0,163.60217
20/03/2023 10:46,2022,1,WESTERN EUROPE-EU,SPAIN,2,LIVERPOOL (JOHN LENNON),BARCELONA,117838,117838,0,20800,20800,0,466.52885
20/03/2023 10:46,2022,1,WESTERN EUROPE-EU,SPAIN,2,LIVERPOOL (JOHN LENNON),BILBAO,0,0,0,52,0,52,-100
20/03/2023 10:46,2022,1,WESTERN EUROPE-EU,SPAIN,2,LIVERPOOL (JOHN LENNON),CASTELLON COSTA AZAHAR,65,0,65,0,0,0,0
20/03/2023 10:46,2022,1,WESTERN EUROPE-EU,SPAIN,2,LIVERPOOL (JOHN LENNON),CASTELLÓN COSTA AZAHAR,1863,0,1863,0,0,0,0
20/03/2023 10:46,2022,1,WESTERN EUROPE-EU,SPAIN,2,LIVERPOOL (JOHN LENNON),GIRONA,21,21,0,1669,1669,0,-98.74176
20/03/2023 10:46,2022,1,WESTERN EUROPE-EU,SPAIN,2,LIVERPOOL (JOHN LENNON),IBIZA,0,0,0,7471,7471,0,-100
20/03/2023 10:46,2022,1,WESTERN EUROPE-EU,SPAIN,2,LIVERPOOL (JOHN LENNON),MADRID,29107,29107,0,748,0,748,3791.31016
20/03/2023 10:46,2022,1,WESTERN EUROPE-EU,SPAIN,2,LIVERPOOL (JOHN LENNON),MALAGA,190534,190534,0,72111,71942,169,164.22321
20/03/2023 10:46,2022,1,WESTERN EUROPE-EU,SPAIN,2,LIVERPOOL (JOHN LENNON),PALMA DE MALLORCA,156364,156364,0,52703,52703,0,196.68899
20/03/2023 10:46,2022,1,WESTERN EUROPE-EU,SPAIN,2,LIVERPOOL (JOHN LENNON),PAMPLONA,0,0,0,126,0,126,-100
20/03/2023 10:46,2022,1,WESTERN EUROPE-EU,SPAIN,2,LIVERPOOL (JOHN LENNON),REUS,18662,18662,0,2034,2034,0,817.50246
20/03/2023 10:46,2022,1,WESTERN EUROPE-EU,SPAIN,2,LIVERPOOL (JOHN LENNON),SEVILLE,96,0,96,0,0,0,0
20/03/2023 10:46,2022,1,WESTERN EUROPE-EU,SPAIN,2,LIVERPOOL (JOHN LENNON),VALENCIA,2536,0,2536,0,0,0,0
20/03/2023 10:46,2022,1,WESTERN EUROPE-EU,SPAIN,2,LIVERPOOL (JOHN LENNON),VITORIA,479,0,479,0,0,0,0
20/03/2023 10:46,2022,1,WESTERN EUROPE-EU,SPAIN,2,MANCHESTER,ALICANTE,716459,671512,44947,210732,198746,11986,239.98586
20/03/2023 10:46,2022,1,WESTERN EUROPE-EU,SPAIN,2,MANCHESTER,ALMERIA,66833,53847,12986,14022,14022,0,376.62958
20/03/2023 10:46,2022,1,WESTERN EUROPE-EU,SPAIN,2,MANCHESTER,BARCELONA,384713,383033,1680,94608,94346,262,306.63897
20/03/2023 10:46,2022,1,WESTERN EUROPE-EU,SPAIN,2,MANCHESTER,BILBAO,53797,53797,0,1471,1471,0,3557.17199
20/03/2023 10:46,2022,1,WESTERN EUROPE-EU,SPAIN,2,MANCHESTER,CASTELLON COSTA AZAHAR,0,0,0,313,0,313,-100
20/03/2023 10:46,2022,1,WESTERN EUROPE-EU,SPAIN,2,MANCHESTER,GIRONA,49732,41315,8417,7074,7074,0,603.02516
20/03/2023 10:46,2022,1,WESTERN EUROPE-EU,SPAIN,2,MANCHESTER,GRANADA,0,0,0,244,0,244,-100
20/03/2023 10:46,2022,1,WESTERN EUROPE-EU,SPAIN,2,MANCHESTER,IBIZA,275827,230041,45786,86565,66469,20096,218.63571
20/03/2023 10:46,2022,1,WESTERN EUROPE-EU,SPAIN,2,MANCHESTER,JEREZ,67,0,67,100,0,100,-33
20/03/2023 10:46,2022,1,WESTERN EUROPE-EU,SPAIN,2,MANCHESTER,MADRID,141978,137269,4709,44468,44428,40,219.28128
20/03/2023 10:46,2022,1,WESTERN EUROPE-EU,SPAIN,2,MANCHESTER,MAHON,141856,95625,46231,34501,22078,12423,311.16489
20/03/2023 10:46,2022,1,WESTERN EUROPE-EU,SPAIN,2,MANCHESTER,MALAGA,524725,473072,51653,161869,146951,14918,224.16646
20/03/2023 10:46,2022,1,WESTERN EUROPE-EU,SPAIN,2,MANCHESTER,MURCIA INTERNATIONAL,80945,80945,0,35161,35161,0,130.21245
20/03/2023 10:46,2022,1,WESTERN EUROPE-EU,SPAIN,2,MANCHESTER,PALMA DE MALLORCA,705082,593828,111254,213640,177479,36161,230.03277
20/03/2023 10:46,2022,1,WESTERN EUROPE-EU,SPAIN,2,MANCHESTER,REUS,98789,66840,31949,6999,5108,1891,1311.47307
20/03/2023 10:46,2022,1,WESTERN EUROPE-EU,SPAIN,2,MANCHESTER,SANTANDER,32783,32783,0,8461,8461,0,287.46011
20/03/2023 10:46,2022,1,WESTERN EUROPE-EU,SPAIN,2,MANCHESTER,SEVILLE,48582,48522,60,16842,16842,0,188.45743
20/03/2023 10:46,2022,1,WESTERN EUROPE-EU,SPAIN,2,MANCHESTER,VALENCIA,57504,57416,88,17107,16517,590,236.1431
20/03/2023 10:46,2022,1,WESTERN EUROPE-EU,SPAIN,2,MANCHESTER,VITORIA,522,0,522,0,0,0,0
20/03/2023 10:46,2022,1,WESTERN EUROPE-EU,SPAIN,2,NEWCASTLE,ALICANTE,240557,240557,0,67903,67903,0,254.26564
20/03/2023 10:46,2022,1,WESTERN EUROPE-EU,SPAIN,2,NEWCASTLE,BARCELONA,5606,5606,0,4228,4228,0,32.59224
20/03/2023 10:46,2022,1,WESTERN EUROPE-EU,SPAIN,2,NEWCASTLE,GIRONA,12174,12108,66,0,0,0,0
20/03/2023 10:46,2022,1,WESTERN EUROPE-EU,SPAIN,2,NEWCASTLE,IBIZA,104809,104809,0,17443,17443,0,500.86568
20/03/2023 10:46,2022,1,WESTERN EUROPE-EU,SPAIN,2,NEWCASTLE,MADRID,86,0,86,0,0,0,0
20/03/2023 10:46,2022,1,WESTERN EUROPE-EU,SPAIN,2,NEWCASTLE,MAHON,60874,60874,0,5007,5007,0,1115.77791
20/03/2023 10:46,2022,1,WESTERN EUROPE-EU,SPAIN,2,NEWCASTLE,MALAGA,148294,148294,0,43402,43402,0,241.6755
20/03/2023 10:46,2022,1,WESTERN EUROPE-EU,SPAIN,2,NEWCASTLE,PALMA DE MALLORCA,239492,239492,0,56541,56541,0,323.57227
20/03/2023 10:46,2022,1,WESTERN EUROPE-EU,SPAIN,2,NEWCASTLE,REUS,43260,43260,0,0,0,0,0
20/03/2023 10:46,2022,1,WESTERN EUROPE-EU,SPAIN,2,NEWCASTLE,VALENCIA,0,0,0,70,0,70,-100
20/03/2023 10:46,2022,1,WESTERN EUROPE-EU,SPAIN,2,NEWQUAY,ALICANTE,30433,30433,0,8905,8905,0,241.75182
20/03/2023 10:46,2022,1,WESTERN EUROPE-EU,SPAIN,2,NORWICH,IBIZA,8088,0,8088,0,0,0,0
20/03/2023 10:46,2022,1,WESTERN EUROPE-EU,SPAIN,2,NORWICH,MAHON,13880,0,13880,0,0,0,0
20/03/2023 10:46,2022,1,WESTERN EUROPE-EU,SPAIN,2,NORWICH,PALMA DE MALLORCA,26323,0,26323,3299,0,3299,697.90846
20/03/2023 10:46,2022,1,WESTERN EUROPE-EU,SPAIN,2,PRESTWICK,ALICANTE,81298,81298,0,21235,21235,0,282.84907
20/03/2023 10:46,2022,1,WESTERN EUROPE-EU,SPAIN,2,PRESTWICK,BARCELONA,29762,29762,0,1654,1654,0,1699.39541
20/03/2023 10:46,2022,1,WESTERN EUROPE-EU,SPAIN,2,PRESTWICK,IBIZA,0,0,0,1685,1685,0,-100
20/03/2023 10:46,2022,1,WESTERN EUROPE-EU,SPAIN,2,PRESTWICK,JEREZ,475,0,475,0,0,0,0
20/03/2023 10:46,2022,1,WESTERN EUROPE-EU,SPAIN,2,PRESTWICK,MALAGA,62079,61925,154,11057,11057,0,461.44524
20/03/2023 10:46,2022,1,WESTERN EUROPE-EU,SPAIN,2,PRESTWICK,MURCIA INTERNATIONAL,20111,20111,0,7389,7389,0,172.17485
20/03/2023 10:46,2022,1,WESTERN EUROPE-EU,SPAIN,2,PRESTWICK,PALMA DE MALLORCA,57779,57779,0,4922,4922,0,1073.89273
20/03/2023 10:46,2022,1,WESTERN EUROPE-EU,SPAIN,2,PRESTWICK,SANTANDER,100,0,100,0,0,0,0
20/03/2023 10:46,2022,1,WESTERN EUROPE-EU,SPAIN,2,SOUTHAMPTON,ALICANTE,4077,4077,0,1809,1809,0,125.37313
20/03/2023 10:46,2022,1,WESTERN EUROPE-EU,SPAIN,2,SOUTHAMPTON,BARCELONA,57,57,0,0,0,0,0
20/03/2023 10:46,2022,1,WESTERN EUROPE-EU,SPAIN,2,SOUTHAMPTON,IBIZA,3342,3342,0,2619,2619,0,27.60596
20/03/2023 10:46,2022,1,WESTERN EUROPE-EU,SPAIN,2,SOUTHAMPTON,MALAGA,7404,7404,0,2854,2854,0,159.42537
20/03/2023 10:46,2022,1,WESTERN EUROPE-EU,SPAIN,2,SOUTHAMPTON,PALMA DE MALLORCA,12768,9564,3204,3516,3516,0,263.13993
20/03/2023 10:46,2022,1,WESTERN EUROPE-EU,SPAIN,2,SOUTHAMPTON,REUS,87,0,87,0,0,0,0
20/03/2023 10:46,2022,1,WESTERN EUROPE-EU,SPAIN,2,SOUTHAMPTON,VALENCIA,50,0,50,0,0,0,0
20/03/2023 10:46,2022,1,WESTERN EUROPE-EU,SPAIN,2,TEESSIDE INTERNATIONAL AIRPORT,ALICANTE,31190,31190,0,11260,11260,0,176.99822
20/03/2023 10:46,2022,1,WESTERN EUROPE-EU,SPAIN,2,TEESSIDE INTERNATIONAL AIRPORT,PALMA DE MALLORCA,26660,17911,8749,5365,5365,0,396.92451
20/03/2023 10:46,2022,1,WESTERN EUROPE-EU,SPAIN(CANARY ISLANDS),1,GATWICK,ARRECIFE,353946,294970,58976,79706,60120,19586,344.06444
20/03/2023 10:46,2022,1,WESTERN EUROPE-EU,SPAIN(CANARY ISLANDS),1,GATWICK,FUERTEVENTURA,159039,111723,47316,41416,25258,16158,284.00377
20/03/2023 10:46,2022,1,WESTERN EUROPE-EU,SPAIN(CANARY ISLANDS),1,GATWICK,LAS PALMAS,229915,165261,64654,51743,30051,21692,344.3403
20/03/2023 10:46,2022,1,WESTERN EUROPE-EU,SPAIN(CANARY ISLANDS),1,GATWICK,SANTA CRUZ DE LA PALMA,11826,0,11826,1746,0,1746,577.31959
20/03/2023 10:46,2022,1,WESTERN EUROPE-EU,SPAIN(CANARY ISLANDS),1,GATWICK,TENERIFE (SURREINA SOFIA),574445,459697,114748,116565,86963,29602,392.81088
20/03/2023 10:46,2022,1,WESTERN EUROPE-EU,SPAIN(CANARY ISLANDS),1,HEATHROW,ARRECIFE,15147,15147,0,31138,31138,0,-51.35526
20/03/2023 10:46,2022,1,WESTERN EUROPE-EU,SPAIN(CANARY ISLANDS),1,HEATHROW,LAS PALMAS,6121,6121,0,10104,9943,161,-39.42003
20/03/2023 10:46,2022,1,WESTERN EUROPE-EU,SPAIN(CANARY ISLANDS),1,HEATHROW,TENERIFE (SURREINA SOFIA),102417,102417,0,72329,72329,0,41.59881
20/03/2023 10:46,2022,1,WESTERN EUROPE-EU,SPAIN(CANARY ISLANDS),1,LUTON,ARRECIFE,95609,66090,29519,25164,21598,3566,279.94357
20/03/2023 10:46,2022,1,WESTERN EUROPE-EU,SPAIN(CANARY ISLANDS),1,LUTON,FUERTEVENTURA,88954,88954,0,23531,23531,0,278.02898
20/03/2023 10:46,2022,1,WESTERN EUROPE-EU,SPAIN(CANARY ISLANDS),1,LUTON,LAS PALMAS,91177,91177,0,23142,23142,0,293.98928
20/03/2023 10:46,2022,1,WESTERN EUROPE-EU,SPAIN(CANARY ISLANDS),1,LUTON,TENERIFE (SURREINA SOFIA),215250,205243,10007,62720,59944,2776,243.19196
20/03/2023 10:46,2022,1,WESTERN EUROPE-EU,SPAIN(CANARY ISLANDS),1,STANSTED,ARRECIFE,264803,264803,0,71258,71258,0,271.61161
20/03/2023 10:46,2022,1,WESTERN EUROPE-EU,SPAIN(CANARY ISLANDS),1,STANSTED,FUERTEVENTURA,158052,158052,0,37393,37393,0,322.67804
20/03/2023 10:46,2022,1,WESTERN EUROPE-EU,SPAIN(CANARY ISLANDS),1,STANSTED,LAS PALMAS,187572,161755,25817,56475,50306,6169,232.1328
20/03/2023 10:46,2022,1,WESTERN EUROPE-EU,SPAIN(CANARY ISLANDS),1,STANSTED,TENERIFE (SURREINA SOFIA),451476,436515,14961,121754,118247,3507,270.80999
20/03/2023 10:46,2022,1,WESTERN EUROPE-EU,SPAIN(CANARY ISLANDS),2,ABERDEEN,LAS PALMAS,0,0,0,42,0,42,-100
20/03/2023 10:46,2022,1,WESTERN EUROPE-EU,SPAIN(CANARY ISLANDS),2,ABERDEEN,TENERIFE (SURREINA SOFIA),27613,0,27613,6983,0,6983,295.43176
20/03/2023 10:46,2022,1,WESTERN EUROPE-EU,SPAIN(CANARY ISLANDS),2,BELFAST INTERNATIONAL,ARRECIFE,79270,72308,6962,23553,23403,150,236.5601
20/03/2023 10:46,2022,1,WESTERN EUROPE-EU,SPAIN(CANARY ISLANDS),2,BELFAST INTERNATIONAL,FUERTEVENTURA,26612,26612,0,3045,3045,0,773.95731
20/03/2023 10:46,2022,1,WESTERN EUROPE-EU,SPAIN(CANARY ISLANDS),2,BELFAST INTERNATIONAL,LAS PALMAS,35232,35232,0,8133,8133,0,333.19808
20/03/2023 10:46,2022,1,WESTERN EUROPE-EU,SPAIN(CANARY ISLANDS),2,BELFAST INTERNATIONAL,TENERIFE (SURREINA SOFIA),118597,111219,7378,33593,33593,0,253.04081
20/03/2023 10:46,2022,1,WESTERN EUROPE-EU,SPAIN(CANARY ISLANDS),2,BIGGIN HILL,LAS PALMAS,0,0,0,12,0,12,-100
20/03/2023 10:46,2022,1,WESTERN EUROPE-EU,SPAIN(CANARY ISLANDS),2,BIRMINGHAM,ARRECIFE,224840,171622,53218,60623,43341,17282,270.88234
20/03/2023 10:46,2022,1,WESTERN EUROPE-EU,SPAIN(CANARY ISLANDS),2,BIRMINGHAM,FUERTEVENTURA,145448,110222,35226,33786,24606,9180,330.49784
20/03/2023 10:46,2022,1,WESTERN EUROPE-EU,SPAIN(CANARY ISLANDS),2,BIRMINGHAM,LAS PALMAS,157237,107043,50194,43202,24685,18517,263.95769
20/03/2023 10:46,2022,1,WESTERN EUROPE-EU,SPAIN(CANARY ISLANDS),2,BIRMINGHAM,TENERIFE (SURREINA SOFIA),348888,270016,78872,93384,74766,18618,273.60576
20/03/2023 10:46,2022,1,WESTERN EUROPE-EU,SPAIN(CANARY ISLANDS),2,BOURNEMOUTH,ARRECIFE,29567,2169,27398,8153,0,8153,262.65178
20/03/2023 10:46,2022,1,WESTERN EUROPE-EU,SPAIN(CANARY ISLANDS),2,BOURNEMOUTH,LAS PALMAS,20514,11423,9091,4291,1280,3011,378.07038
20/03/2023 10:46,2022,1,WESTERN EUROPE-EU,SPAIN(CANARY ISLANDS),2,BOURNEMOUTH,TENERIFE (SURREINA SOFIA),55073,27708,27365,12877,6164,6713,327.68502
20/03/2023 10:46,2022,1,WESTERN EUROPE-EU,SPAIN(CANARY ISLANDS),2,BRISTOL,ARRECIFE,184930,155409,29521,46477,38698,7779,297.89573
20/03/2023 10:46,2022,1,WESTERN EUROPE-EU,SPAIN(CANARY ISLANDS),2,BRISTOL,FUERTEVENTURA,92602,63349,29253,18612,14606,4006,397.53922
20/03/2023 10:46,2022,1,WESTERN EUROPE-EU,SPAIN(CANARY ISLANDS),2,BRISTOL,LAS PALMAS,135723,106673,29050,28529,22895,5634,375.73697
20/03/2023 10:46,2022,1,WESTERN EUROPE-EU,SPAIN(CANARY ISLANDS),2,BRISTOL,TENERIFE (SURREINA SOFIA),295418,247219,48199,68196,62634,5562,333.18963
20/03/2023 10:46,2022,1,WESTERN EUROPE-EU,SPAIN(CANARY ISLANDS),2,CARDIFF WALES,ARRECIFE,40390,6553,33837,6847,0,6847,489.89338
20/03/2023 10:46,2022,1,WESTERN EUROPE-EU,SPAIN(CANARY ISLANDS),2,CARDIFF WALES,LAS PALMAS,16228,0,16228,3276,0,3276,395.3602
20/03/2023 10:46,2022,1,WESTERN EUROPE-EU,SPAIN(CANARY ISLANDS),2,CARDIFF WALES,TENERIFE (SURREINA SOFIA),72194,20006,52188,10107,0,10107,614.29702
20/03/2023 10:46,2022,1,WESTERN EUROPE-EU,SPAIN(CANARY ISLANDS),2,DONCASTER SHEFFIELD,ARRECIFE,53327,6414,46913,18441,2194,16247,189.17629
20/03/2023 10:46,2022,1,WESTERN EUROPE-EU,SPAIN(CANARY ISLANDS),2,DONCASTER SHEFFIELD,FUERTEVENTURA,469,469,0,1292,1292,0,-63.69969
20/03/2023 10:46,2022,1,WESTERN EUROPE-EU,SPAIN(CANARY ISLANDS),2,DONCASTER SHEFFIELD,LAS PALMAS,15006,0,15006,5934,0,5934,152.8817
20/03/2023 10:46,2022,1,WESTERN EUROPE-EU,SPAIN(CANARY ISLANDS),2,DONCASTER SHEFFIELD,TENERIFE (SURREINA SOFIA),61978,12612,49366,19966,5307,14659,210.41771
20/03/2023 10:46,2022,1,WESTERN EUROPE-EU,SPAIN(CANARY ISLANDS),2,EAST MIDLANDS INTERNATIONAL,ARRECIFE,173831,141735,32096,46263,42179,4084,275.7452
20/03/2023 10:46,2022,1,WESTERN EUROPE-EU,SPAIN(CANARY ISLANDS),2,EAST MIDLANDS INTERNATIONAL,FUERTEVENTURA,60722,60722,0,17895,17895,0,239.32383
20/03/2023 10:46,2022,1,WESTERN EUROPE-EU,SPAIN(CANARY ISLANDS),2,EAST MIDLANDS INTERNATIONAL,LAS PALMAS,57884,57702,182,13243,13243,0,337.09129
20/03/2023 10:46,2022,1,WESTERN EUROPE-EU,SPAIN(CANARY ISLANDS),2,EAST MIDLANDS INTERNATIONAL,TENERIFE (NORTE LOS RODEOS),0,0,0,90,90,0,-100
20/03/2023 10:46,2022,1,WESTERN EUROPE-EU,SPAIN(CANARY ISLANDS),2,EAST MIDLANDS INTERNATIONAL,TENERIFE (SURREINA SOFIA),274514,224441,50073,72768,61526,11242,277.24549
20/03/2023 10:46,2022,1,WESTERN EUROPE-EU,SPAIN(CANARY ISLANDS),2,EDINBURGH,ARRECIFE,151160,151160,0,32386,31395,991,366.74489
20/03/2023 10:46,2022,1,WESTERN EUROPE-EU,SPAIN(CANARY ISLANDS),2,EDINBURGH,FUERTEVENTURA,80928,80928,0,18336,18336,0,341.36126
20/03/2023 10:46,2022,1,WESTERN EUROPE-EU,SPAIN(CANARY ISLANDS),2,EDINBURGH,LAS PALMAS,66068,66068,0,16991,16991,0,288.84115
20/03/2023 10:46,2022,1,WESTERN EUROPE-EU,SPAIN(CANARY ISLANDS),2,EDINBURGH,TENERIFE (SURREINA SOFIA),285021,270445,14576,68838,63718,5120,314.04602
20/03/2023 10:46,2022,1,WESTERN EUROPE-EU,SPAIN(CANARY ISLANDS),2,EXETER,ARRECIFE,26224,185,26039,5970,0,5970,339.26298
20/03/2023 10:46,2022,1,WESTERN EUROPE-EU,SPAIN(CANARY ISLANDS),2,EXETER,LAS PALMAS,9126,0,9126,2836,0,2836,221.79126
20/03/2023 10:46,2022,1,WESTERN EUROPE-EU,SPAIN(CANARY ISLANDS),2,EXETER,TENERIFE (SURREINA SOFIA),18717,0,18717,5821,0,5821,221.54269
20/03/2023 10:46,2022,1,WESTERN EUROPE-EU,SPAIN(CANARY ISLANDS),2,GLASGOW,ARRECIFE,113490,80329,33161,27134,19561,7573,318.25754
20/03/2023 10:46,2022,1,WESTERN EUROPE-EU,SPAIN(CANARY ISLANDS),2,GLASGOW,FUERTEVENTURA,37507,37507,0,6667,6667,0,462.57687
20/03/2023 10:46,2022,1,WESTERN EUROPE-EU,SPAIN(CANARY ISLANDS),2,GLASGOW,LAS PALMAS,96823,70428,26395,18967,15454,3513,410.48136
20/03/2023 10:46,2022,1,WESTERN EUROPE-EU,SPAIN(CANARY ISLANDS),2,GLASGOW,TENERIFE (SURREINA SOFIA),220216,169137,51079,52371,45392,6979,320.49226
20/03/2023 10:46,2022,1,WESTERN EUROPE-EU,SPAIN(CANARY ISLANDS),2,JERSEY,TENERIFE (SURREINA SOFIA),3266,0,3266,198,0,198,1549.49495
20/03/2023 10:46,2022,1,WESTERN EUROPE-EU,SPAIN(CANARY ISLANDS),2,LEEDS BRADFORD,ARRECIFE,148733,148733,0,34465,34465,0,331.54795
20/03/2023 10:46,2022,1,WESTERN EUROPE-EU,SPAIN(CANARY ISLANDS),2,LEEDS BRADFORD,FUERTEVENTURA,79379,79379,0,12889,12889,0,515.86624
20/03/2023 10:46,2022,1,WESTERN EUROPE-EU,SPAIN(CANARY ISLANDS),2,LEEDS BRADFORD,LAS PALMAS,59278,59278,0,13267,13267,0,346.80787
20/03/2023 10:46,2022,1,WESTERN EUROPE-EU,SPAIN(CANARY ISLANDS),2,LEEDS BRADFORD,TENERIFE (SURREINA SOFIA),191476,191300,176,49187,49187,0,289.28172
20/03/2023 10:46,2022,1,WESTERN EUROPE-EU,SPAIN(CANARY ISLANDS),2,LIVERPOOL (JOHN LENNON),ARRECIFE,46378,46378,0,12650,12650,0,266.62451
20/03/2023 10:46,2022,1,WESTERN EUROPE-EU,SPAIN(CANARY ISLANDS),2,LIVERPOOL (JOHN LENNON),FUERTEVENTURA,18863,18863,0,5396,5396,0,249.57376
20/03/2023 10:46,2022,1,WESTERN EUROPE-EU,SPAIN(CANARY ISLANDS),2,LIVERPOOL (JOHN LENNON),TENERIFE (SURREINA SOFIA),71690,71690,0,11745,11745,0,510.3874
20/03/2023 10:46,2022,1,WESTERN EUROPE-EU,SPAIN(CANARY ISLANDS),2,MANCHESTER,ARRECIFE,451906,373617,78289,138152,110052,28100,227.10782
20/03/2023 10:46,2022,1,WESTERN EUROPE-EU,SPAIN(CANARY ISLANDS),2,MANCHESTER,FUERTEVENTURA,223742,172086,51656,64206,47034,17172,248.47522
20/03/2023 10:46,2022,1,WESTERN EUROPE-EU,SPAIN(CANARY ISLANDS),2,MANCHESTER,LAS PALMAS,288525,209307,79218,81821,50532,31289,252.62952
20/03/2023 10:46,2022,1,WESTERN EUROPE-EU,SPAIN(CANARY ISLANDS),2,MANCHESTER,SANTA CRUZ DE LA PALMA,12072,0,12072,1620,0,1620,645.18519
20/03/2023 10:46,2022,1,WESTERN EUROPE-EU,SPAIN(CANARY ISLANDS),2,MANCHESTER,TENERIFE (SURREINA SOFIA),814495,680774,133721,251043,216257,34786,224.44442
20/03/2023 10:46,2022,1,WESTERN EUROPE-EU,SPAIN(CANARY ISLANDS),2,NEWCASTLE,ARRECIFE,140191,140191,0,28333,28333,0,394.79759
20/03/2023 10:46,2022,1,WESTERN EUROPE-EU,SPAIN(CANARY ISLANDS),2,NEWCASTLE,FUERTEVENTURA,66162,66162,0,9739,9739,0,579.35106
20/03/2023 10:46,2022,1,WESTERN EUROPE-EU,SPAIN(CANARY ISLANDS),2,NEWCASTLE,LAS PALMAS,99922,99922,0,13892,13892,0,619.27728
20/03/2023 10:46,2022,1,WESTERN EUROPE-EU,SPAIN(CANARY ISLANDS),2,NEWCASTLE,TENERIFE (SURREINA SOFIA),237928,237739,189,59887,59887,0,297.29491
20/03/2023 10:46,2022,1,WESTERN EUROPE-EU,SPAIN(CANARY ISLANDS),2,NORWICH,TENERIFE (SURREINA SOFIA),22110,0,22110,4593,0,4593,381.38472
20/03/2023 10:46,2022,1,WESTERN EUROPE-EU,SPAIN(CANARY ISLANDS),2,PRESTWICK,ARRECIFE,28536,28536,0,2289,2289,0,1146.65793
20/03/2023 10:46,2022,1,WESTERN EUROPE-EU,SPAIN(CANARY ISLANDS),2,PRESTWICK,LAS PALMAS,23341,23341,0,0,0,0,0
20/03/2023 10:46,2022,1,WESTERN EUROPE-EU,SPAIN(CANARY ISLANDS),2,PRESTWICK,TENERIFE (SURREINA SOFIA),86547,86547,0,19869,19869,0,335.5881
20/03/2023 10:46,2022,1,WESTERN EUROPE-EU,SPAIN(CANARY ISLANDS),2,TEESSIDE INTERNATIONAL AIRPORT,ARRECIFE,134,134,0,0,0,0,0
20/03/2023 10:46,2022,1,WESTERN EUROPE-EU,SWEDEN,1,GATWICK,HALMSTAD,363,0,363,0,0,0,0
20/03/2023 10:46,2022,1,WESTERN EUROPE-EU,SWEDEN,1,GATWICK,MALMO,0,0,0,285,0,285,-100
20/03/2023 10:46,2022,1,WESTERN EUROPE-EU,SWEDEN,1,GATWICK,PAJALA YLLAS,374,0,374,178,0,178,110.11236
20/03/2023 10:46,2022,1,WESTERN EUROPE-EU,SWEDEN,1,GATWICK,SCANDINAVIAN MOUNTAINS AIRPORT,674,0,674,0,0,0,0
20/03/2023 10:46,2022,1,WESTERN EUROPE-EU,SWEDEN,1,GATWICK,STOCKHOLM (ARLANDA),300270,300270,0,28071,28071,0,969.68045
20/03/2023 10:46,2022,1,WESTERN EUROPE-EU,SWEDEN,1,HEATHROW,GOTEBORG (LANDVETTER),163926,163926,0,26756,26756,0,512.67006
20/03/2023 10:46,2022,1,WESTERN EUROPE-EU,SWEDEN,1,HEATHROW,LULEA,1248,1248,0,0,0,0,0
20/03/2023 10:46,2022,1,WESTERN EUROPE-EU,SWEDEN,1,HEATHROW,SCANDINAVIAN MOUNTAINS AIRPORT,537,537,0,0,0,0,0
20/03/2023 10:46,2022,1,WESTERN EUROPE-EU,SWEDEN,1,HEATHROW,STOCKHOLM (ARLANDA),626261,626261,0,171246,171246,0,265.7084
20/03/2023 10:46,2022,1,WESTERN EUROPE-EU,SWEDEN,1,LUTON,MALMO,0,0,0,205,0,205,-100
20/03/2023 10:46,2022,1,WESTERN EUROPE-EU,SWEDEN,1,STANSTED,GOTEBORG (LANDVETTER),114772,114772,0,38917,38917,0,194.91482
20/03/2023 10:46,2022,1,WESTERN EUROPE-EU,SWEDEN,1,STANSTED,OREBRO,23306,23306,0,0,0,0,0
20/03/2023 10:46,2022,1,WESTERN EUROPE-EU,SWEDEN,1,STANSTED,STOCKHOLM (ARLANDA),141446,140815,631,18676,18495,181,657.36774
20/03/2023 10:46,2022,1,WESTERN EUROPE-EU,SWEDEN,1,STANSTED,STOCKHOLM (SKAVSTA),0,0,0,15342,15342,0,-100
20/03/2023 10:46,2022,1,WESTERN EUROPE-EU,SWEDEN,1,STANSTED,VASTERAS,47154,47154,0,16882,16882,0,179.31525
20/03/2023 10:46,2022,1,WESTERN EUROPE-EU,SWEDEN,1,STANSTED,VAXJO,20724,20724,0,0,0,0,0
20/03/2023 10:46,2022,1,WESTERN EUROPE-EU,SWEDEN,2,ABERDEEN,GOTEBORG (LANDVETTER),0,0,0,206,0,206,-100
20/03/2023 10:46,2022,1,WESTERN EUROPE-EU,SWEDEN,2,ABERDEEN,RONNEBY,0,0,0,105,0,105,-100
20/03/2023 10:46,2022,1,WESTERN EUROPE-EU,SWEDEN,2,BELFAST INTERNATIONAL,PAJALA YLLAS,375,0,375,0,0,0,0
20/03/2023 10:46,2022,1,WESTERN EUROPE-EU,SWEDEN,2,BELFAST INTERNATIONAL,SKELLEFTEA,61,0,61,0,0,0,0
20/03/2023 10:46,2022,1,WESTERN EUROPE-EU,SWEDEN,2,BELFAST INTERNATIONAL,STOCKHOLM (ARLANDA),13,0,13,0,0,0,0
20/03/2023 10:46,2022,1,WESTERN EUROPE-EU,SWEDEN,2,BIGGIN HILL,GOTEBORG (LANDVETTER),0,0,0,8,0,8,-100
20/03/2023 10:46,2022,1,WESTERN EUROPE-EU,SWEDEN,2,BIGGIN HILL,MALMO,0,0,0,4,0,4,-100
20/03/2023 10:46,2022,1,WESTERN EUROPE-EU,SWEDEN,2,BIGGIN HILL,STOCKHOLM (BROMMA),2,0,2,4,0,4,-50
20/03/2023 10:46,2022,1,WESTERN EUROPE-EU,SWEDEN,2,BIRMINGHAM,PAJALA YLLAS,367,0,367,368,0,368,-0.27174
20/03/2023 10:46,2022,1,WESTERN EUROPE-EU,SWEDEN,2,BIRMINGHAM,SCANDINAVIAN MOUNTAINS AIRPORT,0,0,0,238,0,238,-100
20/03/2023 10:46,2022,1,WESTERN EUROPE-EU,SWEDEN,2,BIRMINGHAM,STOCKHOLM (ARLANDA),15245,15245,0,0,0,0,0
20/03/2023 10:46,2022,1,WESTERN EUROPE-EU,SWEDEN,2,BOURNEMOUTH,PAJALA YLLAS,358,0,358,351,0,351,1.9943
20/03/2023 10:46,2022,1,WESTERN EUROPE-EU,SWEDEN,2,CARDIFF WALES,PAJALA YLLAS,366,0,366,360,0,360,1.66667
20/03/2023 10:46,2022,1,WESTERN EUROPE-EU,SWEDEN,2,EAST MIDLANDS INTERNATIONAL,PAJALA YLLAS,0,0,0,170,0,170,-100
20/03/2023 10:46,2022,1,WESTERN EUROPE-EU,SWEDEN,2,EDINBURGH,GOTEBORG (LANDVETTER),33930,33930,0,5085,5085,0,567.25664
20/03/2023 10:46,2022,1,WESTERN EUROPE-EU,SWEDEN,2,EDINBURGH,RONNEBY,0,0,0,15,0,15,-100
20/03/2023 10:46,2022,1,WESTERN EUROPE-EU,SWEDEN,2,EDINBURGH,STOCKHOLM (ARLANDA),55553,55553,0,7437,7437,0,646.98131
20/03/2023 10:46,2022,1,WESTERN EUROPE-EU,SWEDEN,2,EXETER,PAJALA YLLAS,358,0,358,336,0,336,6.54762
20/03/2023 10:46,2022,1,WESTERN EUROPE-EU,SWEDEN,2,GLASGOW,GOTEBORG (LANDVETTER),0,0,0,165,0,165,-100
20/03/2023 10:46,2022,1,WESTERN EUROPE-EU,SWEDEN,2,GLASGOW,MALMO,0,0,0,201,47,154,-100
20/03/2023 10:46,2022,1,WESTERN EUROPE-EU,SWEDEN,2,GLASGOW,PAJALA YLLAS,374,0,374,336,0,336,11.30952
20/03/2023 10:46,2022,1,WESTERN EUROPE-EU,SWEDEN,2,GLASGOW,STOCKHOLM (ARLANDA),0,0,0,72,0,72,-100
20/03/2023 10:46,2022,1,WESTERN EUROPE-EU,SWEDEN,2,HUMBERSIDE,PAJALA YLLAS,748,0,748,720,0,720,3.88889
20/03/2023 10:46,2022,1,WESTERN EUROPE-EU,SWEDEN,2,HUMBERSIDE,STOCKHOLM (ARLANDA),68,0,68,0,0,0,0
20/03/2023 10:46,2022,1,WESTERN EUROPE-EU,SWEDEN,2,ISLE OF MAN,STOCKHOLM (BROMMA),105,0,105,0,0,0,0
20/03/2023 10:46,2022,1,WESTERN EUROPE-EU,SWEDEN,2,LEEDS BRADFORD,PAJALA YLLAS,376,0,376,170,170,0,121.17647
20/03/2023 10:46,2022,1,WESTERN EUROPE-EU,SWEDEN,2,LIVERPOOL (JOHN LENNON),PAJALA YLLAS,376,0,376,360,0,360,4.44444
20/03/2023 10:46,2022,1,WESTERN EUROPE-EU,SWEDEN,2,LIVERPOOL (JOHN LENNON),STOCKHOLM (ARLANDA),27751,27443,308,2775,2775,0,900.03604
20/03/2023 10:46,2022,1,WESTERN EUROPE-EU,SWEDEN,2,MANCHESTER,GOTEBORG (LANDVETTER),31808,31808,0,6811,6811,0,367.00925
20/03/2023 10:46,2022,1,WESTERN EUROPE-EU,SWEDEN,2,MANCHESTER,STOCKHOLM (ARLANDA),67049,66824,225,14446,14446,0,364.1354
20/03/2023 10:46,2022,1,WESTERN EUROPE-EU,SWEDEN,2,NEWCASTLE,RONNEBY,0,0,0,11,0,11,-100
20/03/2023 10:46,2022,1,WESTERN EUROPE-EU,SWEDEN,2,NEWCASTLE,STOCKHOLM (ARLANDA),56,0,56,0,0,0,0
20/03/2023 10:46,2022,1,WESTERN EUROPE-EU,SWEDEN,2,NORWICH,PAJALA YLLAS,376,0,376,179,0,179,110.05587
20/03/2023 10:46,2022,1,WESTERN EUROPE-EU,SWEDEN,2,PRESTWICK,GOTEBORG (LANDVETTER),120,0,120,0,0,0,0
20/03/2023 10:46,2022,1,WESTERN EUROPE-EU,SWEDEN,2,TEESSIDE INTERNATIONAL AIRPORT,OREBRO,58,0,58,0,0,0,0
20/03/2023 10:46,2022,1,WESTERN EUROPE-EU,SWEDEN,2,TEESSIDE INTERNATIONAL AIRPORT,PAJALA YLLAS,374,0,374,0,0,0,0
20/03/2023 10:46,2022,2,WESTERN EUROPE-OTHER,BOSNIA-HERZEGOVINA,1,GATWICK,SARAJEVO,182,0,182,0,0,0,0
20/03/2023 10:46,2022,2,WESTERN EUROPE-OTHER,BOSNIA-HERZEGOVINA,1,LUTON,SARAJEVO,22737,22737,0,0,0,0,0
20/03/2023 10:46,2022,2,WESTERN EUROPE-OTHER,BOSNIA-HERZEGOVINA,1,LUTON,TUZLA,152,152,0,0,0,0,0
20/03/2023 10:46,2022,2,WESTERN EUROPE-OTHER,BOSNIA-HERZEGOVINA,1,STANSTED,SARAJEVO,0,0,0,38,0,38,-100
20/03/2023 10:46,2022,2,WESTERN EUROPE-OTHER,BOSNIA-HERZEGOVINA,2,BELFAST INTERNATIONAL,BANJA LUKA,0,0,0,158,0,158,-100
20/03/2023 10:46,2022,2,WESTERN EUROPE-OTHER,BOSNIA-HERZEGOVINA,2,BELFAST INTERNATIONAL,MOSTAR,0,0,0,97,0,97,-100
20/03/2023 10:46,2022,2,WESTERN EUROPE-OTHER,BOSNIA-HERZEGOVINA,2,BELFAST INTERNATIONAL,SARAJEVO,0,0,0,60,0,60,-100
20/03/2023 10:46,2022,2,WESTERN EUROPE-OTHER,BOSNIA-HERZEGOVINA,2,BIGGIN HILL,SARAJEVO,0,0,0,8,0,8,-100
20/03/2023 10:46,2022,2,WESTERN EUROPE-OTHER,FAROE ISLANDS,2,ABERDEEN,VAGAR,341,0,341,338,0,338,0.88757
20/03/2023 10:46,2022,2,WESTERN EUROPE-OTHER,FAROE ISLANDS,2,EDINBURGH,VAGAR,14974,14974,0,2802,2802,0,434.404
20/03/2023 10:46,2022,2,WESTERN EUROPE-OTHER,FAROE ISLANDS,2,GLASGOW,VAGAR,0,0,0,144,0,144,-100
20/03/2023 10:46,2022,2,WESTERN EUROPE-OTHER,ICELAND,1,GATWICK,KEFLAVIK,141040,135119,5921,16614,15893,721,748.9226
20/03/2023 10:46,2022,2,WESTERN EUROPE-OTHER,ICELAND,1,HEATHROW,KEFLAVIK,293609,293609,0,110691,110691,0,165.25101
20/03/2023 10:46,2022,2,WESTERN EUROPE-OTHER,ICELAND,1,LUTON,KEFLAVIK,135983,135983,0,34636,34636,0,292.60596
20/03/2023 10:46,2022,2,WESTERN EUROPE-OTHER,ICELAND,1,STANSTED,AKUREYRI,145,83,62,0,0,0,0
20/03/2023 10:46,2022,2,WESTERN EUROPE-OTHER,ICELAND,1,STANSTED,KEFLAVIK,82093,82024,69,18083,18083,0,353.97888
20/03/2023 10:46,2022,2,WESTERN EUROPE-OTHER,ICELAND,2,ABERDEEN,KEFLAVIK,0,0,0,98,0,98,-100
20/03/2023 10:46,2022,2,WESTERN EUROPE-OTHER,ICELAND,2,ABERDEEN,REYKJAVIK,0,0,0,80,0,80,-100
20/03/2023 10:46,2022,2,WESTERN EUROPE-OTHER,ICELAND,2,BELFAST INTERNATIONAL,KEFLAVIK,664,664,0,125,0,125,431.2
20/03/2023 10:46,2022,2,WESTERN EUROPE-OTHER,ICELAND,2,BIGGIN HILL,KEFLAVIK,14,0,14,0,0,0,0
20/03/2023 10:46,2022,2,WESTERN EUROPE-OTHER,ICELAND,2,BIRMINGHAM,KEFLAVIK,11491,11491,0,3239,3239,0,254.76999
20/03/2023 10:46,2022,2,WESTERN EUROPE-OTHER,ICELAND,2,BRISTOL,KEFLAVIK,17625,15433,2192,4283,4283,0,311.51062
20/03/2023 10:46,2022,2,WESTERN EUROPE-OTHER,ICELAND,2,EAST MIDLANDS INTERNATIONAL,KEFLAVIK,1502,1413,89,477,477,0,214.8847
20/03/2023 10:46,2022,2,WESTERN EUROPE-OTHER,ICELAND,2,EDINBURGH,AKUREYRI,645,0,645,153,0,153,321.56863
20/03/2023 10:46,2022,2,WESTERN EUROPE-OTHER,ICELAND,2,EDINBURGH,KEFLAVIK,34638,34638,0,10585,10373,212,227.23666
20/03/2023 10:46,2022,2,WESTERN EUROPE-OTHER,ICELAND,2,GLASGOW,EGILSSTADIR,296,0,296,319,0,319,-7.21003
20/03/2023 10:46,2022,2,WESTERN EUROPE-OTHER,ICELAND,2,GLASGOW,KEFLAVIK,59802,59802,0,2534,2534,0,2259.98421
20/03/2023 10:46,2022,2,WESTERN EUROPE-OTHER,ICELAND,2,INVERNESS,KEFLAVIK,170,170,0,0,0,0,0
20/03/2023 10:46,2022,2,WESTERN EUROPE-OTHER,ICELAND,2,LEEDS BRADFORD,KEFLAVIK,2704,2704,0,437,437,0,518.7643
20/03/2023 10:46,2022,2,WESTERN EUROPE-OTHER,ICELAND,2,LIVERPOOL (JOHN LENNON),KEFLAVIK,5722,5634,88,0,0,0,0
20/03/2023 10:46,2022,2,WESTERN EUROPE-OTHER,ICELAND,2,MANCHESTER,KEFLAVIK,160384,154623,5761,44257,43589,668,262.39239
20/03/2023 10:46,2022,2,WESTERN EUROPE-OTHER,ICELAND,2,NEWCASTLE,KEFLAVIK,2900,2900,0,1083,1083,0,167.7747
20/03/2023 10:46,2022,2,WESTERN EUROPE-OTHER,KOSOVO,1,GATWICK,PRISTINA,6962,6962,0,154,0,154,4420.77922
20/03/2023 10:46,2022,2,WESTERN EUROPE-OTHER,KOSOVO,1,HEATHROW,PRISTINA,4285,4285,0,8032,8032,0,-46.6509
20/03/2023 10:46,2022,2,WESTERN EUROPE-OTHER,KOSOVO,1,LUTON,PRISTINA,101016,101016,0,45948,45948,0,119.84852
20/03/2023 10:46,2022,2,WESTERN EUROPE-OTHER,KOSOVO,2,BELFAST CITY (GEORGE BEST),PRISTINA,116,0,116,0,0,0,0
20/03/2023 10:46,2022,2,WESTERN EUROPE-OTHER,KOSOVO,2,BELFAST INTERNATIONAL,PRISTINA,110,0,110,0,0,0,0
20/03/2023 10:46,2022,2,WESTERN EUROPE-OTHER,KOSOVO,2,BIGGIN HILL,PRISTINA,6,0,6,0,0,0,0
20/03/2023 10:46,2022,2,WESTERN EUROPE-OTHER,KOSOVO,2,MANCHESTER,PRISTINA,0,0,0,116,0,116,-100
20/03/2023 10:46,2022,2,WESTERN EUROPE-OTHER,KOSOVO,2,PRESTWICK,PRISTINA,189,0,189,0,0,0,0
20/03/2023 10:46,2022,2,WESTERN EUROPE-OTHER,MACEDONIA,1,LUTON,OHRID,11218,11218,0,0,0,0,0
20/03/2023 10:46,2022,2,WESTERN EUROPE-OTHER,MACEDONIA,1,LUTON,SKOPJE,61659,61659,0,39536,39536,0,55.9566
20/03/2023 10:46,2022,2,WESTERN EUROPE-OTHER,MACEDONIA,1,STANSTED,SKOPJE,174,0,174,0,0,0,0
20/03/2023 10:46,2022,2,WESTERN EUROPE-OTHER,MACEDONIA,2,BELFAST INTERNATIONAL,SKOPJE,47,0,47,80,0,80,-41.25
20/03/2023 10:46,2022,2,WESTERN EUROPE-OTHER,MACEDONIA,2,BIGGIN HILL,SKOPJE,0,0,0,2,0,2,-100
20/03/2023 10:46,2022,2,WESTERN EUROPE-OTHER,NORWAY,1,GATWICK,ALESUND,219,0,219,0,0,0,0
20/03/2023 10:46,2022,2,WESTERN EUROPE-OTHER,NORWAY,1,GATWICK,BERGEN,149518,149004,514,15072,14863,209,892.02495
20/03/2023 10:46,2022,2,WESTERN EUROPE-OTHER,NORWAY,1,GATWICK,OSLO (GARDERMOEN),344392,344392,0,51076,51076,0,574.27363
20/03/2023 10:46,2022,2,WESTERN EUROPE-OTHER,NORWAY,1,GATWICK,STAVANGER,93185,93185,0,8532,8532,0,992.18237
20/03/2023 10:46,2022,2,WESTERN EUROPE-OTHER,NORWAY,1,GATWICK,TROMSOE,11143,11143,0,1300,1300,0,757.15385
20/03/2023 10:46,2022,2,WESTERN EUROPE-OTHER,NORWAY,1,GATWICK,TRONDHEIM (VAERNES),41600,41600,0,1109,1109,0,3651.12714
20/03/2023 10:46,2022,2,WESTERN EUROPE-OTHER,NORWAY,1,HEATHROW,BERGEN,57411,57411,0,16974,16974,0,238.22906
20/03/2023 10:46,2022,2,WESTERN EUROPE-OTHER,NORWAY,1,HEATHROW,OSLO (GARDERMOEN),479248,479208,40,96313,96313,0,397.5943
20/03/2023 10:46,2022,2,WESTERN EUROPE-OTHER,NORWAY,1,HEATHROW,STAVANGER,29735,29735,0,0,0,0,0
20/03/2023 10:46,2022,2,WESTERN EUROPE-OTHER,NORWAY,1,LUTON,BODO,705,0,705,0,0,0,0
20/03/2023 10:46,2022,2,WESTERN EUROPE-OTHER,NORWAY,1,LUTON,OSLO (GARDERMOEN),49,0,49,0,0,0,0
20/03/2023 10:46,2022,2,WESTERN EUROPE-OTHER,NORWAY,1,LUTON,TROMSOE,2234,2234,0,0,0,0,0
20/03/2023 10:46,2022,2,WESTERN EUROPE-OTHER,NORWAY,1,SOUTHEND,BERGEN,104,104,0,0,0,0,0
20/03/2023 10:46,2022,2,WESTERN EUROPE-OTHER,NORWAY,1,SOUTHEND,BODO,336,0,336,0,0,0,0
20/03/2023 10:46,2022,2,WESTERN EUROPE-OTHER,NORWAY,1,STANSTED,BERGEN,1076,1076,0,0,0,0,0
20/03/2023 10:46,2022,2,WESTERN EUROPE-OTHER,NORWAY,1,STANSTED,BODO,186,0,186,0,0,0,0
20/03/2023 10:46,2022,2,WESTERN EUROPE-OTHER,NORWAY,1,STANSTED,OSLO (GARDERMOEN),166779,166650,129,42037,42037,0,296.74335
20/03/2023 10:46,2022,2,WESTERN EUROPE-OTHER,NORWAY,1,STANSTED,SANDEFJORD(TORP),55019,55019,0,3290,3290,0,1572.31003
20/03/2023 10:46,2022,2,WESTERN EUROPE-OTHER,NORWAY,2,ABERDEEN,ALESUND,0,0,0,9,0,9,-100
20/03/2023 10:46,2022,2,WESTERN EUROPE-OTHER,NORWAY,2,ABERDEEN,BERGEN,38120,38120,0,13990,13922,68,172.48034
20/03/2023 10:46,2022,2,WESTERN EUROPE-OTHER,NORWAY,2,ABERDEEN,HAUGESUND,32,32,0,44,44,0,-27.27273
20/03/2023 10:46,2022,2,WESTERN EUROPE-OTHER,NORWAY,2,ABERDEEN,OSLO (GARDERMOEN),3591,3591,0,0,0,0,0
20/03/2023 10:46,2022,2,WESTERN EUROPE-OTHER,NORWAY,2,ABERDEEN,STAVANGER,62664,62664,0,21659,21659,0,189.32084
20/03/2023 10:46,2022,2,WESTERN EUROPE-OTHER,NORWAY,2,BELFAST INTERNATIONAL,BODO,113,0,113,0,0,0,0
20/03/2023 10:46,2022,2,WESTERN EUROPE-OTHER,NORWAY,2,BELFAST INTERNATIONAL,MOLDE,80,0,80,0,0,0,0
20/03/2023 10:46,2022,2,WESTERN EUROPE-OTHER,NORWAY,2,BELFAST INTERNATIONAL,OSLO (GARDERMOEN),98,0,98,0,0,0,0
20/03/2023 10:46,2022,2,WESTERN EUROPE-OTHER,NORWAY,2,BIGGIN HILL,SANDEFJORD(TORP),20,0,20,0,0,0,0
20/03/2023 10:46,2022,2,WESTERN EUROPE-OTHER,NORWAY,2,BIRMINGHAM,BERGEN,198,0,198,167,0,167,18.56287
20/03/2023 10:46,2022,2,WESTERN EUROPE-OTHER,NORWAY,2,BIRMINGHAM,BODO,116,0,116,0,0,0,0
20/03/2023 10:46,2022,2,WESTERN EUROPE-OTHER,NORWAY,2,BIRMINGHAM,MOLDE,40,0,40,0,0,0,0
20/03/2023 10:46,2022,2,WESTERN EUROPE-OTHER,NORWAY,2,BIRMINGHAM,TRONDHEIM (VAERNES),118,0,118,0,0,0,0
20/03/2023 10:46,2022,2,WESTERN EUROPE-OTHER,NORWAY,2,BOURNEMOUTH,BERGEN,306,0,306,0,0,0,0
20/03/2023 10:46,2022,2,WESTERN EUROPE-OTHER,NORWAY,2,BRISTOL,BERGEN,376,7,369,200,0,200,88
20/03/2023 10:46,2022,2,WESTERN EUROPE-OTHER,NORWAY,2,EDINBURGH,BERGEN,5309,5309,0,0,0,0,0
20/03/2023 10:46,2022,2,WESTERN EUROPE-OTHER,NORWAY,2,EDINBURGH,OSLO (GARDERMOEN),107927,106753,1174,13475,13475,0,700.94249
20/03/2023 10:46,2022,2,WESTERN EUROPE-OTHER,NORWAY,2,EDINBURGH,STAVANGER,3451,3451,0,11,11,0,31272.72727
20/03/2023 10:46,2022,2,WESTERN EUROPE-OTHER,NORWAY,2,EXETER,BARDUFOSS,146,0,146,0,0,0,0
20/03/2023 10:46,2022,2,WESTERN EUROPE-OTHER,NORWAY,2,GLASGOW,ALESUND,0,0,0,194,0,194,-100
20/03/2023 10:46,2022,2,WESTERN EUROPE-OTHER,NORWAY,2,GLASGOW,BERGEN,197,0,197,0,0,0,0
20/03/2023 10:46,2022,2,WESTERN EUROPE-OTHER,NORWAY,2,GLASGOW,BODO,1435,0,1435,0,0,0,0
20/03/2023 10:46,2022,2,WESTERN EUROPE-OTHER,NORWAY,2,GLASGOW,SANDEFJORD(TORP),0,0,0,102,102,0,-100
20/03/2023 10:46,2022,2,WESTERN EUROPE-OTHER,NORWAY,2,GLASGOW,TRONDHEIM (VAERNES),0,0,0,68,0,68,-100
20/03/2023 10:46,2022,2,WESTERN EUROPE-OTHER,NORWAY,2,INVERNESS,BODO,20,0,20,0,0,0,0
20/03/2023 10:46,2022,2,WESTERN EUROPE-OTHER,NORWAY,2,LIVERPOOL (JOHN LENNON),ALTA,374,0,374,0,0,0,0
20/03/2023 10:46,2022,2,WESTERN EUROPE-OTHER,NORWAY,2,LIVERPOOL (JOHN LENNON),OSLO (GARDERMOEN),5069,0,5069,354,0,354,1331.9209
20/03/2023 10:46,2022,2,WESTERN EUROPE-OTHER,NORWAY,2,LIVERPOOL (JOHN LENNON),STAVANGER,1258,0,1258,138,0,138,811.5942
20/03/2023 10:46,2022,2,WESTERN EUROPE-OTHER,NORWAY,2,LIVERPOOL (JOHN LENNON),TROMSOE,373,0,373,0,0,0,0
20/03/2023 10:46,2022,2,WESTERN EUROPE-OTHER,NORWAY,2,LIVERPOOL (JOHN LENNON),TRONDHEIM (VAERNES),743,0,743,0,0,0,0
20/03/2023 10:46,2022,2,WESTERN EUROPE-OTHER,NORWAY,2,MANCHESTER,BERGEN,11763,10641,1122,484,298,186,2330.3719
20/03/2023 10:46,2022,2,WESTERN EUROPE-OTHER,NORWAY,2,MANCHESTER,KRISTIANSAND (KJEVIK),285,0,285,0,0,0,0
20/03/2023 10:46,2022,2,WESTERN EUROPE-OTHER,NORWAY,2,MANCHESTER,KRISTIANSUND (KUERNBERGET),123,0,123,0,0,0,0
20/03/2023 10:46,2022,2,WESTERN EUROPE-OTHER,NORWAY,2,MANCHESTER,OSLO (GARDERMOEN),94689,94689,0,15523,15523,0,509.99163
20/03/2023 10:46,2022,2,WESTERN EUROPE-OTHER,NORWAY,2,MANCHESTER,SANDEFJORD(TORP),61363,61363,0,5514,5514,0,1012.85818
20/03/2023 10:46,2022,2,WESTERN EUROPE-OTHER,NORWAY,2,MANCHESTER,STAVANGER,9706,9706,0,0,0,0,0
20/03/2023 10:46,2022,2,WESTERN EUROPE-OTHER,NORWAY,2,MANCHESTER,TRONDHEIM (VAERNES),5614,5614,0,0,0,0,0
20/03/2023 10:46,2022,2,WESTERN EUROPE-OTHER,NORWAY,2,NEWCASTLE,BERGEN,2335,2335,0,202,202,0,1055.94059
20/03/2023 10:46,2022,2,WESTERN EUROPE-OTHER,NORWAY,2,NEWCASTLE,STAVANGER,6497,6497,0,0,0,0,0
20/03/2023 10:46,2022,2,WESTERN EUROPE-OTHER,NORWAY,2,NORWICH,BERGEN,0,0,0,43,0,43,-100
20/03/2023 10:46,2022,2,WESTERN EUROPE-OTHER,NORWAY,2,SUMBURGH,BERGEN,1643,1643,0,0,0,0,0
20/03/2023 10:46,2022,2,WESTERN EUROPE-OTHER,NORWAY,2,TEESSIDE INTERNATIONAL AIRPORT,OSLO (GARDERMOEN),62,0,62,0,0,0,0
20/03/2023 10:46,2022,2,WESTERN EUROPE-OTHER,REPUBLIC OF MONTENEGRO,1,GATWICK,PODGORICA,32829,32829,0,0,0,0,0
20/03/2023 10:46,2022,2,WESTERN EUROPE-OTHER,REPUBLIC OF MONTENEGRO,1,GATWICK,TIVAT,28713,28713,0,3404,3404,0,743.50764
20/03/2023 10:46,2022,2,WESTERN EUROPE-OTHER,REPUBLIC OF MONTENEGRO,1,STANSTED,PODGORICA,56020,56020,0,7264,7264,0,671.20044
20/03/2023 10:46,2022,2,WESTERN EUROPE-OTHER,REPUBLIC OF MONTENEGRO,2,BIGGIN HILL,PODGORICA,0,0,0,3,0,3,-100
20/03/2023 10:46,2022,2,WESTERN EUROPE-OTHER,REPUBLIC OF MONTENEGRO,2,BIGGIN HILL,TIVAT,18,0,18,0,0,0,0
20/03/2023 10:46,2022,2,WESTERN EUROPE-OTHER,REPUBLIC OF MONTENEGRO,2,MANCHESTER,PODGORICA,3950,3950,0,0,0,0,0
20/03/2023 10:46,2022,2,WESTERN EUROPE-OTHER,REPUBLIC OF MONTENEGRO,2,MANCHESTER,TIVAT,19259,19259,0,782,782,0,2362.78772
20/03/2023 10:46,2022,2,WESTERN EUROPE-OTHER,REPUBLIC OF SERBIA,1,HEATHROW,BELGRADE,61434,61434,0,23218,23197,21,164.59643
20/03/2023 10:46,2022,2,WESTERN EUROPE-OTHER,REPUBLIC OF SERBIA,1,LUTON,BELGRADE,74042,74042,0,28144,28144,0,163.08272
20/03/2023 10:46,2022,2,WESTERN EUROPE-OTHER,REPUBLIC OF SERBIA,2,BIGGIN HILL,BELGRADE,5,0,5,0,0,0,0
20/03/2023 10:46,2022,2,WESTERN EUROPE-OTHER,REPUBLIC OF SERBIA,2,GLASGOW,BELGRADE,1746,0,1746,0,0,0,0
20/03/2023 10:46,2022,2,WESTERN EUROPE-OTHER,REPUBLIC OF SERBIA,2,MANCHESTER,BELGRADE,0,0,0,60,0,60,-100
20/03/2023 10:46,2022,2,WESTERN EUROPE-OTHER,REPUBLIC OF SERBIA,2,NEWCASTLE,BELGRADE,60,0,60,0,0,0,0
20/03/2023 10:46,2022,2,WESTERN EUROPE-OTHER,SWITZERLAND,1,GATWICK,BALE MULHOUSE,224095,224095,0,29745,29745,0,653.38712
20/03/2023 10:46,2022,2,WESTERN EUROPE-OTHER,SWITZERLAND,1,GATWICK,GENEVA,611172,605805,5367,94436,94339,97,547.18116
20/03/2023 10:46,2022,2,WESTERN EUROPE-OTHER,SWITZERLAND,1,GATWICK,ZURICH,143070,143070,0,16447,16447,0,769.88509
20/03/2023 10:46,2022,2,WESTERN EUROPE-OTHER,SWITZERLAND,1,HEATHROW,BALE MULHOUSE,168795,168795,0,13533,13533,0,1147.28442
20/03/2023 10:46,2022,2,WESTERN EUROPE-OTHER,SWITZERLAND,1,HEATHROW,GENEVA,894269,894269,0,222073,222073,0,302.69146
20/03/2023 10:46,2022,2,WESTERN EUROPE-OTHER,SWITZERLAND,1,HEATHROW,ZURICH,827907,827441,466,267360,267360,0,209.66001
20/03/2023 10:46,2022,2,WESTERN EUROPE-OTHER,SWITZERLAND,1,LONDON CITY,GENEVA,85728,85728,0,4105,4105,0,1988.38002
20/03/2023 10:46,2022,2,WESTERN EUROPE-OTHER,SWITZERLAND,1,LONDON CITY,ZURICH,293822,293772,50,49318,49318,0,495.77031
20/03/2023 10:46,2022,2,WESTERN EUROPE-OTHER,SWITZERLAND,1,LUTON,BALE MULHOUSE,46,46,0,0,0,0,0
20/03/2023 10:46,2022,2,WESTERN EUROPE-OTHER,SWITZERLAND,1,LUTON,GENEVA,229200,229200,0,28305,28305,0,709.75093
20/03/2023 10:46,2022,2,WESTERN EUROPE-OTHER,SWITZERLAND,1,LUTON,ZURICH,48231,48188,43,5289,5289,0,811.91151
20/03/2023 10:46,2022,2,WESTERN EUROPE-OTHER,SWITZERLAND,1,STANSTED,GENEVA,23167,21785,1382,654,654,0,3442.35474
20/03/2023 10:46,2022,2,WESTERN EUROPE-OTHER,SWITZERLAND,1,STANSTED,ZURICH,250,163,87,0,0,0,0
20/03/2023 10:46,2022,2,WESTERN EUROPE-OTHER,SWITZERLAND,2,ABERDEEN,GENEVA,3169,3169,0,14,14,0,22535.71429
20/03/2023 10:46,2022,2,WESTERN EUROPE-OTHER,SWITZERLAND,2,BELFAST CITY (GEORGE BEST),ALTENRHEIN,6,0,6,0,0,0,0
20/03/2023 10:46,2022,2,WESTERN EUROPE-OTHER,SWITZERLAND,2,BELFAST INTERNATIONAL,BALE MULHOUSE,101,0,101,49,0,49,106.12245
20/03/2023 10:46,2022,2,WESTERN EUROPE-OTHER,SWITZERLAND,2,BELFAST INTERNATIONAL,GENEVA,15202,15192,10,532,478,54,2757.5188
20/03/2023 10:46,2022,2,WESTERN EUROPE-OTHER,SWITZERLAND,2,BELFAST INTERNATIONAL,ZURICH,237,0,237,0,0,0,0
20/03/2023 10:46,2022,2,WESTERN EUROPE-OTHER,SWITZERLAND,2,BIGGIN HILL,ALTENRHEIN,14,0,14,0,0,0,0
20/03/2023 10:46,2022,2,WESTERN EUROPE-OTHER,SWITZERLAND,2,BIGGIN HILL,BERNE,0,0,0,14,0,14,-100
20/03/2023 10:46,2022,2,WESTERN EUROPE-OTHER,SWITZERLAND,2,BIGGIN HILL,GENEVA,40,0,40,18,0,18,122.22222
20/03/2023 10:46,2022,2,WESTERN EUROPE-OTHER,SWITZERLAND,2,BIGGIN HILL,SAMEDAN/ST MORITZ,6,0,6,0,0,0,0
20/03/2023 10:46,2022,2,WESTERN EUROPE-OTHER,SWITZERLAND,2,BIGGIN HILL,SION,31,0,31,15,0,15,106.66667
20/03/2023 10:46,2022,2,WESTERN EUROPE-OTHER,SWITZERLAND,2,BIGGIN HILL,ZURICH,37,0,37,30,0,30,23.33333
20/03/2023 10:46,2022,2,WESTERN EUROPE-OTHER,SWITZERLAND,2,BIRMINGHAM,GENEVA,88573,88573,0,4405,4405,0,1910.7378
20/03/2023 10:46,2022,2,WESTERN EUROPE-OTHER,SWITZERLAND,2,BIRMINGHAM,ZURICH,24134,24134,0,4441,4315,126,443.43616
20/03/2023 10:46,2022,2,WESTERN EUROPE-OTHER,SWITZERLAND,2,BOURNEMOUTH,GENEVA,16184,16184,0,757,757,0,2037.91281
20/03/2023 10:46,2022,2,WESTERN EUROPE-OTHER,SWITZERLAND,2,BRISTOL,BALE MULHOUSE,28202,28202,0,750,750,0,3660.26667
20/03/2023 10:46,2022,2,WESTERN EUROPE-OTHER,SWITZERLAND,2,BRISTOL,BERNE,0,0,0,69,0,69,-100
20/03/2023 10:46,2022,2,WESTERN EUROPE-OTHER,SWITZERLAND,2,BRISTOL,GENEVA,156079,152710,3369,15852,15852,0,884.60131
20/03/2023 10:46,2022,2,WESTERN EUROPE-OTHER,SWITZERLAND,2,CARDIFF WALES,GENEVA,0,0,0,37,0,37,-100
20/03/2023 10:46,2022,2,WESTERN EUROPE-OTHER,SWITZERLAND,2,CARDIFF WALES,ZURICH,107,0,107,0,0,0,0
20/03/2023 10:46,2022,2,WESTERN EUROPE-OTHER,SWITZERLAND,2,EAST MIDLANDS INTERNATIONAL,GENEVA,4523,4523,0,0,0,0,0
20/03/2023 10:46,2022,2,WESTERN EUROPE-OTHER,SWITZERLAND,2,EDINBURGH,BALE MULHOUSE,79571,79571,0,7890,7890,0,908.50444
20/03/2023 10:46,2022,2,WESTERN EUROPE-OTHER,SWITZERLAND,2,EDINBURGH,GENEVA,158898,158898,0,14034,14034,0,1032.236
20/03/2023 10:46,2022,2,WESTERN EUROPE-OTHER,SWITZERLAND,2,EDINBURGH,ZURICH,45772,45698,74,2254,2254,0,1930.70098
20/03/2023 10:46,2022,2,WESTERN EUROPE-OTHER,SWITZERLAND,2,EXETER,GENEVA,166,0,166,0,0,0,0
20/03/2023 10:46,2022,2,WESTERN EUROPE-OTHER,SWITZERLAND,2,GLASGOW,GENEVA,13104,13104,0,377,377,0,3375.86207
20/03/2023 10:46,2022,2,WESTERN EUROPE-OTHER,SWITZERLAND,2,GUERNSEY,GENEVA,226,226,0,0,0,0,0
20/03/2023 10:46,2022,2,WESTERN EUROPE-OTHER,SWITZERLAND,2,GUERNSEY,ZURICH,449,449,0,0,0,0,0
20/03/2023 10:46,2022,2,WESTERN EUROPE-OTHER,SWITZERLAND,2,INVERNESS,GENEVA,2,0,2,0,0,0,0
20/03/2023 10:46,2022,2,WESTERN EUROPE-OTHER,SWITZERLAND,2,JERSEY,ZURICH,543,0,543,0,0,0,0
20/03/2023 10:46,2022,2,WESTERN EUROPE-OTHER,SWITZERLAND,2,LEEDS BRADFORD,GENEVA,25018,25018,0,446,446,0,5509.41704
20/03/2023 10:46,2022,2,WESTERN EUROPE-OTHER,SWITZERLAND,2,LIVERPOOL (JOHN LENNON),GENEVA,58743,58743,0,1809,1726,83,3147.26368
20/03/2023 10:46,2022,2,WESTERN EUROPE-OTHER,SWITZERLAND,2,LIVERPOOL (JOHN LENNON),SION,19,0,19,0,0,0,0
20/03/2023 10:46,2022,2,WESTERN EUROPE-OTHER,SWITZERLAND,2,MANCHESTER,BALE MULHOUSE,63642,63642,0,4045,4045,0,1473.34981
20/03/2023 10:46,2022,2,WESTERN EUROPE-OTHER,SWITZERLAND,2,MANCHESTER,BERNE,0,0,0,389,0,389,-100
20/03/2023 10:46,2022,2,WESTERN EUROPE-OTHER,SWITZERLAND,2,MANCHESTER,GENEVA,237270,232505,4765,41104,41104,0,477.24309
20/03/2023 10:46,2022,2,WESTERN EUROPE-OTHER,SWITZERLAND,2,MANCHESTER,ZURICH,101122,101122,0,28550,28550,0,254.19264
20/03/2023 10:46,2022,2,WESTERN EUROPE-OTHER,SWITZERLAND,2,NEWCASTLE,GENEVA,10425,10425,0,108,108,0,9552.77778
20/03/2023 10:46,2022,2,WESTERN EUROPE-OTHER,SWITZERLAND,2,NEWQUAY,ZURICH,2443,2443,0,0,0,0,0
20/03/2023 10:46,2022,2,WESTERN EUROPE-OTHER,SWITZERLAND,2,SOUTHAMPTON,GENEVA,9357,9357,0,358,358,0,2513.68715
20/03/2023 10:46,2022,2,WESTERN EUROPE-OTHER,TURKEY,1,GATWICK,ANTALYA,574772,443494,131278,23620,19005,4615,2333.41236
20/03/2023 10:46,2022,2,WESTERN EUROPE-OTHER,TURKEY,1,GATWICK,BODRUM (MILAS),158412,136162,22250,405,405,0,39014.07407
20/03/2023 10:46,2022,2,WESTERN EUROPE-OTHER,TURKEY,1,GATWICK,DALAMAN,411887,312154,99733,11677,8611,3066,3427.33579
20/03/2023 10:46,2022,2,WESTERN EUROPE-OTHER,TURKEY,1,GATWICK,ISTANBUL,231302,231302,0,36208,36208,0,538.81463
20/03/2023 10:46,2022,2,WESTERN EUROPE-OTHER,TURKEY,1,GATWICK,ISTANBUL (SABIHA GOKCEN),0,0,0,8,0,8,-100
20/03/2023 10:46,2022,2,WESTERN EUROPE-OTHER,TURKEY,1,GATWICK,IZMIR (ADNAN MENDERES),66193,42993,23200,707,0,707,9262.51768
20/03/2023 10:46,2022,2,WESTERN EUROPE-OTHER,TURKEY,1,GATWICK,KAYSERI  ERKILET,502,365,137,0,0,0,0
20/03/2023 10:46,2022,2,WESTERN EUROPE-OTHER,TURKEY,1,HEATHROW,ANTALYA,0,0,0,1663,1663,0,-100
20/03/2023 10:46,2022,2,WESTERN EUROPE-OTHER,TURKEY,1,HEATHROW,BODRUM (MILAS),6334,6334,0,911,911,0,595.27991
20/03/2023 10:46,2022,2,WESTERN EUROPE-OTHER,TURKEY,1,HEATHROW,DALAMAN,43089,43089,0,2928,2928,0,1371.61885
20/03/2023 10:46,2022,2,WESTERN EUROPE-OTHER,TURKEY,1,HEATHROW,ISTANBUL,1103949,1103949,0,385503,385489,14,186.36586
20/03/2023 10:46,2022,2,WESTERN EUROPE-OTHER,TURKEY,1,HEATHROW,ISTANBUL (SABIHA GOKCEN),0,0,0,7901,7901,0,-100
20/03/2023 10:46,2022,2,WESTERN EUROPE-OTHER,TURKEY,1,LUTON,ANKARA (ESENBOGA),3493,3493,0,0,0,0,0
20/03/2023 10:46,2022,2,WESTERN EUROPE-OTHER,TURKEY,1,LUTON,ANTALYA,88977,88483,494,5547,5547,0,1504.05625
20/03/2023 10:46,2022,2,WESTERN EUROPE-OTHER,TURKEY,1,LUTON,BODRUM (MILAS),54263,54263,0,0,0,0,0
20/03/2023 10:46,2022,2,WESTERN EUROPE-OTHER,TURKEY,1,LUTON,DALAMAN,92959,80486,12473,1754,1754,0,5199.82896
20/03/2023 10:46,2022,2,WESTERN EUROPE-OTHER,TURKEY,1,LUTON,GAZIANTEP,4408,4408,0,957,957,0,360.60606
20/03/2023 10:46,2022,2,WESTERN EUROPE-OTHER,TURKEY,1,LUTON,ISTANBUL ATATURK,81,81,0,0,0,0,0
20/03/2023 10:46,2022,2,WESTERN EUROPE-OTHER,TURKEY,1,LUTON,IZMIR (ADNAN MENDERES),26248,26248,0,534,534,0,4815.35581
20/03/2023 10:46,2022,2,WESTERN EUROPE-OTHER,TURKEY,1,STANSTED,ANKARA (ESENBOGA),35508,35508,0,1288,1288,0,2656.8323
20/03/2023 10:46,2022,2,WESTERN EUROPE-OTHER,TURKEY,1,STANSTED,ANTALYA,320545,292961,27584,30029,30029,0,967.45146
20/03/2023 10:46,2022,2,WESTERN EUROPE-OTHER,TURKEY,1,STANSTED,BODRUM (MILAS),35814,35469,345,210,210,0,16954.28571
20/03/2023 10:46,2022,2,WESTERN EUROPE-OTHER,TURKEY,1,STANSTED,DALAMAN,163299,134350,28949,15225,15225,0,972.57143
20/03/2023 10:46,2022,2,WESTERN EUROPE-OTHER,TURKEY,1,STANSTED,ISTANBUL,909,746,163,0,0,0,0
20/03/2023 10:46,2022,2,WESTERN EUROPE-OTHER,TURKEY,1,STANSTED,ISTANBUL (SABIHA GOKCEN),726387,726387,0,204382,204382,0,255.40654
20/03/2023 10:46,2022,2,WESTERN EUROPE-OTHER,TURKEY,1,STANSTED,IZMIR (ADNAN MENDERES),124087,124087,0,15022,14775,247,726.03515
20/03/2023 10:46,2022,2,WESTERN EUROPE-OTHER,TURKEY,1,STANSTED,KAYSERI  ERKILET,184,0,184,0,0,0,0
20/03/2023 10:46,2022,2,WESTERN EUROPE-OTHER,TURKEY,2,ABERDEEN,DALAMAN,17679,182,17497,0,0,0,0
20/03/2023 10:46,2022,2,WESTERN EUROPE-OTHER,TURKEY,2,BELFAST INTERNATIONAL,ANTALYA,24494,24494,0,2710,2710,0,803.83764
20/03/2023 10:46,2022,2,WESTERN EUROPE-OTHER,TURKEY,2,BELFAST INTERNATIONAL,DALAMAN,45687,39539,6148,1468,1468,0,3012.19346
20/03/2023 10:46,2022,2,WESTERN EUROPE-OTHER,TURKEY,2,BIGGIN HILL,ANTALYA,5,0,5,4,0,4,25
20/03/2023 10:46,2022,2,WESTERN EUROPE-OTHER,TURKEY,2,BIGGIN HILL,BODRUM (MILAS),6,0,6,1,0,1,500
20/03/2023 10:46,2022,2,WESTERN EUROPE-OTHER,TURKEY,2,BIGGIN HILL,DALAMAN,7,0,7,0,0,0,0
20/03/2023 10:46,2022,2,WESTERN EUROPE-OTHER,TURKEY,2,BIGGIN HILL,ISTANBUL,6,0,6,0,0,0,0
20/03/2023 10:46,2022,2,WESTERN EUROPE-OTHER,TURKEY,2,BIGGIN HILL,ISTANBUL ATATURK,39,0,39,5,0,5,680
20/03/2023 10:46,2022,2,WESTERN EUROPE-OTHER,TURKEY,2,BIRMINGHAM,ANTALYA,249111,195730,53381,18230,14220,4010,1266.4893
20/03/2023 10:46,2022,2,WESTERN EUROPE-OTHER,TURKEY,2,BIRMINGHAM,BODRUM (MILAS),41044,25784,15260,0,0,0,0
20/03/2023 10:46,2022,2,WESTERN EUROPE-OTHER,TURKEY,2,BIRMINGHAM,DALAMAN,154129,87107,67022,13473,11000,2473,1043.98426
20/03/2023 10:46,2022,2,WESTERN EUROPE-OTHER,TURKEY,2,BIRMINGHAM,ISTANBUL,148189,148189,0,32798,32798,0,351.82328
20/03/2023 10:46,2022,2,WESTERN EUROPE-OTHER,TURKEY,2,BIRMINGHAM,ISTANBUL (SABIHA GOKCEN),0,0,0,209,0,209,-100
20/03/2023 10:46,2022,2,WESTERN EUROPE-OTHER,TURKEY,2,BIRMINGHAM,IZMIR (ADNAN MENDERES),36347,18882,17465,0,0,0,0
20/03/2023 10:46,2022,2,WESTERN EUROPE-OTHER,TURKEY,2,BOURNEMOUTH,ANTALYA,6187,0,6187,0,0,0,0
20/03/2023 10:46,2022,2,WESTERN EUROPE-OTHER,TURKEY,2,BOURNEMOUTH,DALAMAN,7664,0,7664,0,0,0,0
20/03/2023 10:46,2022,2,WESTERN EUROPE-OTHER,TURKEY,2,BRISTOL,ANTALYA,131446,101159,30287,5845,5845,0,2148.86228
20/03/2023 10:46,2022,2,WESTERN EUROPE-OTHER,TURKEY,2,BRISTOL,BODRUM (MILAS),69753,55273,14480,0,0,0,0
20/03/2023 10:46,2022,2,WESTERN EUROPE-OTHER,TURKEY,2,BRISTOL,DALAMAN,144591,113035,31556,5326,5326,0,2614.81412
20/03/2023 10:46,2022,2,WESTERN EUROPE-OTHER,TURKEY,2,BRISTOL,IZMIR (ADNAN MENDERES),9396,9396,0,0,0,0,0
20/03/2023 10:46,2022,2,WESTERN EUROPE-OTHER,TURKEY,2,CARDIFF WALES,ANTALYA,13970,0,13970,0,0,0,0
20/03/2023 10:46,2022,2,WESTERN EUROPE-OTHER,TURKEY,2,CARDIFF WALES,DALAMAN,24223,0,24223,0,0,0,0
20/03/2023 10:46,2022,2,WESTERN EUROPE-OTHER,TURKEY,2,CARDIFF WALES,ISTANBUL,51,0,51,0,0,0,0
20/03/2023 10:46,2022,2,WESTERN EUROPE-OTHER,TURKEY,2,CARDIFF WALES,TRABZON,50,0,50,0,0,0,0
20/03/2023 10:46,2022,2,WESTERN EUROPE-OTHER,TURKEY,2,DONCASTER SHEFFIELD,ANTALYA,37796,0,37796,0,0,0,0
20/03/2023 10:46,2022,2,WESTERN EUROPE-OTHER,TURKEY,2,DONCASTER SHEFFIELD,DALAMAN,29912,0,29912,0,0,0,0
20/03/2023 10:46,2022,2,WESTERN EUROPE-OTHER,TURKEY,2,DUNDEE,BODRUM (MILAS),8,0,8,0,0,0,0
20/03/2023 10:46,2022,2,WESTERN EUROPE-OTHER,TURKEY,2,EAST MIDLANDS INTERNATIONAL,ANTALYA,42024,42024,0,2750,2750,0,1428.14545
20/03/2023 10:46,2022,2,WESTERN EUROPE-OTHER,TURKEY,2,EAST MIDLANDS INTERNATIONAL,BODRUM (MILAS),9031,9031,0,0,0,0,0
20/03/2023 10:46,2022,2,WESTERN EUROPE-OTHER,TURKEY,2,EAST MIDLANDS INTERNATIONAL,DALAMAN,63947,46322,17625,4789,4789,0,1235.2892
20/03/2023 10:46,2022,2,WESTERN EUROPE-OTHER,TURKEY,2,EAST MIDLANDS INTERNATIONAL,IZMIR (ADNAN MENDERES),8847,8847,0,0,0,0,0
20/03/2023 10:46,2022,2,WESTERN EUROPE-OTHER,TURKEY,2,EDINBURGH,ANTALYA,89440,89440,0,6898,6898,0,1196.60771
20/03/2023 10:46,2022,2,WESTERN EUROPE-OTHER,TURKEY,2,EDINBURGH,BODRUM (MILAS),28618,28618,0,0,0,0,0
20/03/2023 10:46,2022,2,WESTERN EUROPE-OTHER,TURKEY,2,EDINBURGH,DALAMAN,67262,61346,5916,2624,2624,0,2463.33841
20/03/2023 10:46,2022,2,WESTERN EUROPE-OTHER,TURKEY,2,EDINBURGH,DIYARBAKIR,132,0,132,0,0,0,0
20/03/2023 10:46,2022,2,WESTERN EUROPE-OTHER,TURKEY,2,EDINBURGH,ISTANBUL,99666,99666,0,14951,14757,194,566.61762
20/03/2023 10:46,2022,2,WESTERN EUROPE-OTHER,TURKEY,2,EDINBURGH,IZMIR (ADNAN MENDERES),7694,7649,45,0,0,0,0
20/03/2023 10:46,2022,2,WESTERN EUROPE-OTHER,TURKEY,2,EXETER,DALAMAN,13127,0,13127,0,0,0,0
20/03/2023 10:46,2022,2,WESTERN EUROPE-OTHER,TURKEY,2,GLASGOW,ANTALYA,112168,85480,26688,9767,7621,2146,1048.43862
20/03/2023 10:46,2022,2,WESTERN EUROPE-OTHER,TURKEY,2,GLASGOW,BODRUM (MILAS),8731,8731,0,0,0,0,0
20/03/2023 10:46,2022,2,WESTERN EUROPE-OTHER,TURKEY,2,GLASGOW,DALAMAN,112345,81508,30837,7538,5901,1637,1390.38206
20/03/2023 10:46,2022,2,WESTERN EUROPE-OTHER,TURKEY,2,GLASGOW,ISTANBUL,132,0,132,0,0,0,0
20/03/2023 10:46,2022,2,WESTERN EUROPE-OTHER,TURKEY,2,GLASGOW,IZMIR (ADNAN MENDERES),8666,8666,0,0,0,0,0
20/03/2023 10:46,2022,2,WESTERN EUROPE-OTHER,TURKEY,2,GUERNSEY,ISTANBUL (SABIHA GOKCEN),0,0,0,6,0,6,-100
20/03/2023 10:46,2022,2,WESTERN EUROPE-OTHER,TURKEY,2,HUMBERSIDE,ANTALYA,719,0,719,0,0,0,0
20/03/2023 10:46,2022,2,WESTERN EUROPE-OTHER,TURKEY,2,LEEDS BRADFORD,ANTALYA,78763,78763,0,10151,10151,0,675.9137
20/03/2023 10:46,2022,2,WESTERN EUROPE-OTHER,TURKEY,2,LEEDS BRADFORD,BODRUM (MILAS),17478,17478,0,0,0,0,0
20/03/2023 10:46,2022,2,WESTERN EUROPE-OTHER,TURKEY,2,LEEDS BRADFORD,DALAMAN,68558,68558,0,7708,7708,0,789.43954
20/03/2023 10:46,2022,2,WESTERN EUROPE-OTHER,TURKEY,2,LEEDS BRADFORD,IZMIR (ADNAN MENDERES),8637,8637,0,0,0,0,0
20/03/2023 10:46,2022,2,WESTERN EUROPE-OTHER,TURKEY,2,LIVERPOOL (JOHN LENNON),ANTALYA,20147,20147,0,0,0,0,0
20/03/2023 10:46,2022,2,WESTERN EUROPE-OTHER,TURKEY,2,LIVERPOOL (JOHN LENNON),BODRUM (MILAS),17602,17602,0,0,0,0,0
20/03/2023 10:46,2022,2,WESTERN EUROPE-OTHER,TURKEY,2,LIVERPOOL (JOHN LENNON),DALAMAN,17846,17846,0,1142,1142,0,1462.69702
20/03/2023 10:46,2022,2,WESTERN EUROPE-OTHER,TURKEY,2,LIVERPOOL (JOHN LENNON),IZMIR (ADNAN MENDERES),7348,7348,0,0,0,0,0
20/03/2023 10:46,2022,2,WESTERN EUROPE-OTHER,TURKEY,2,MANCHESTER,ANTALYA,581136,494391,86745,41807,33981,7826,1290.04473
20/03/2023 10:46,2022,2,WESTERN EUROPE-OTHER,TURKEY,2,MANCHESTER,BODRUM (MILAS),65972,47859,18113,1022,0,1022,6355.18591
20/03/2023 10:46,2022,2,WESTERN EUROPE-OTHER,TURKEY,2,MANCHESTER,DALAMAN,470136,367186,102950,24044,19316,4728,1855.31526
20/03/2023 10:46,2022,2,WESTERN EUROPE-OTHER,TURKEY,2,MANCHESTER,ISTANBUL,300841,300841,0,108308,108308,0,177.76434
20/03/2023 10:46,2022,2,WESTERN EUROPE-OTHER,TURKEY,2,MANCHESTER,ISTANBUL (SABIHA GOKCEN),122076,122076,0,36787,36787,0,231.84549
20/03/2023 10:46,2022,2,WESTERN EUROPE-OTHER,TURKEY,2,MANCHESTER,ISTANBUL ATATURK,26646,26646,0,0,0,0,0
20/03/2023 10:46,2022,2,WESTERN EUROPE-OTHER,TURKEY,2,MANCHESTER,IZMIR (ADNAN MENDERES),58287,38212,20075,557,0,557,10364.45242
20/03/2023 10:46,2022,2,WESTERN EUROPE-OTHER,TURKEY,2,MANCHESTER,KAYSERI  ERKILET,179,179,0,0,0,0,0
20/03/2023 10:46,2022,2,WESTERN EUROPE-OTHER,TURKEY,2,NEWCASTLE,ANTALYA,113684,113684,0,9871,9871,0,1051.69689
20/03/2023 10:46,2022,2,WESTERN EUROPE-OTHER,TURKEY,2,NEWCASTLE,BODRUM (MILAS),17584,17584,0,0,0,0,0
20/03/2023 10:46,2022,2,WESTERN EUROPE-OTHER,TURKEY,2,NEWCASTLE,DALAMAN,116963,116963,0,7514,7514,0,1456.60101
20/03/2023 10:46,2022,2,WESTERN EUROPE-OTHER,TURKEY,2,NEWCASTLE,ISTANBUL,123,0,123,0,0,0,0
20/03/2023 10:46,2022,2,WESTERN EUROPE-OTHER,TURKEY,2,NEWCASTLE,IZMIR (ADNAN MENDERES),9029,9029,0,0,0,0,0
20/03/2023 10:46,2022,2,WESTERN EUROPE-OTHER,TURKEY,2,NORWICH,DALAMAN,14050,0,14050,0,0,0,0
20/03/2023 10:46,2022,3,EASTERN EUROPE-EU,BULGARIA,1,GATWICK,BURGAS,45381,19758,25623,2455,2455,0,1748.51324
20/03/2023 10:46,2022,3,EASTERN EUROPE-EU,BULGARIA,1,GATWICK,SOFIA,155213,147047,8166,47287,46289,998,228.23609
20/03/2023 10:46,2022,3,EASTERN EUROPE-EU,BULGARIA,1,GATWICK,VARNA,24739,24739,0,4279,4279,0,478.1491
20/03/2023 10:46,2022,3,EASTERN EUROPE-EU,BULGARIA,1,HEATHROW,SOFIA,99538,99538,0,48812,48812,0,103.92117
20/03/2023 10:46,2022,3,EASTERN EUROPE-EU,BULGARIA,1,LUTON,BURGAS,90440,90440,0,43049,43049,0,110.08618
20/03/2023 10:46,2022,3,EASTERN EUROPE-EU,BULGARIA,1,LUTON,PLOVDIV,47082,47082,0,5562,5562,0,746.49407
20/03/2023 10:46,2022,3,EASTERN EUROPE-EU,BULGARIA,1,LUTON,SOFIA,271650,271641,9,179964,179964,0,50.94686
20/03/2023 10:46,2022,3,EASTERN EUROPE-EU,BULGARIA,1,LUTON,VARNA,98937,98937,0,66766,66766,0,48.1847
20/03/2023 10:46,2022,3,EASTERN EUROPE-EU,BULGARIA,1,STANSTED,BURGAS,6602,6602,0,0,0,0,0
20/03/2023 10:46,2022,3,EASTERN EUROPE-EU,BULGARIA,1,STANSTED,PLOVDIV,70906,70906,0,20756,20756,0,241.61688
20/03/2023 10:46,2022,3,EASTERN EUROPE-EU,BULGARIA,1,STANSTED,SOFIA,272342,272342,0,124665,124562,103,118.45907
20/03/2023 10:46,2022,3,EASTERN EUROPE-EU,BULGARIA,2,ABERDEEN,BURGAS,4294,0,4294,0,0,0,0
20/03/2023 10:46,2022,3,EASTERN EUROPE-EU,BULGARIA,2,BELFAST INTERNATIONAL,BURGAS,11230,7251,3979,0,0,0,0
20/03/2023 10:46,2022,3,EASTERN EUROPE-EU,BULGARIA,2,BELFAST INTERNATIONAL,PLOVDIV,4636,0,4636,567,0,567,717.63668
20/03/2023 10:46,2022,3,EASTERN EUROPE-EU,BULGARIA,2,BELFAST INTERNATIONAL,SOFIA,3223,0,3223,349,0,349,823.4957
20/03/2023 10:46,2022,3,EASTERN EUROPE-EU,BULGARIA,2,BIGGIN HILL,SOFIA,6,0,6,5,0,5,20
20/03/2023 10:46,2022,3,EASTERN EUROPE-EU,BULGARIA,2,BIRMINGHAM,BURGAS,17205,0,17205,0,0,0,0
20/03/2023 10:46,2022,3,EASTERN EUROPE-EU,BULGARIA,2,BIRMINGHAM,SOFIA,44017,41053,2964,8538,8045,493,415.54228
20/03/2023 10:46,2022,3,EASTERN EUROPE-EU,BULGARIA,2,BIRMINGHAM,VARNA,352,352,0,0,0,0,0
20/03/2023 10:46,2022,3,EASTERN EUROPE-EU,BULGARIA,2,BRISTOL,BURGAS,14820,0,14820,0,0,0,0
20/03/2023 10:46,2022,3,EASTERN EUROPE-EU,BULGARIA,2,BRISTOL,SOFIA,14098,9990,4108,2173,1871,302,548.78049
20/03/2023 10:46,2022,3,EASTERN EUROPE-EU,BULGARIA,2,CARDIFF WALES,BURGAS,14492,0,14492,0,0,0,0
20/03/2023 10:46,2022,3,EASTERN EUROPE-EU,BULGARIA,2,DONCASTER SHEFFIELD,BURGAS,22860,0,22860,2298,2298,0,894.77807
20/03/2023 10:46,2022,3,EASTERN EUROPE-EU,BULGARIA,2,DONCASTER SHEFFIELD,SOFIA,207,207,0,0,0,0,0
20/03/2023 10:46,2022,3,EASTERN EUROPE-EU,BULGARIA,2,EAST MIDLANDS INTERNATIONAL,BURGAS,8858,7211,1647,0,0,0,0
20/03/2023 10:46,2022,3,EASTERN EUROPE-EU,BULGARIA,2,EAST MIDLANDS INTERNATIONAL,SOFIA,3295,2289,1006,444,119,325,642.11712
20/03/2023 10:46,2022,3,EASTERN EUROPE-EU,BULGARIA,2,EDINBURGH,BURGAS,9933,6564,3369,0,0,0,0
20/03/2023 10:46,2022,3,EASTERN EUROPE-EU,BULGARIA,2,EDINBURGH,SOFIA,35770,35770,0,18358,18358,0,94.84693
20/03/2023 10:46,2022,3,EASTERN EUROPE-EU,BULGARIA,2,GLASGOW,BURGAS,10395,7738,2657,0,0,0,0
20/03/2023 10:46,2022,3,EASTERN EUROPE-EU,BULGARIA,2,GLASGOW,SOFIA,266,0,266,147,81,66,80.95238
20/03/2023 10:46,2022,3,EASTERN EUROPE-EU,BULGARIA,2,HUMBERSIDE,BURGAS,4853,0,4853,0,0,0,0
20/03/2023 10:46,2022,3,EASTERN EUROPE-EU,BULGARIA,2,LEEDS BRADFORD,BURGAS,16561,13738,2823,0,0,0,0
20/03/2023 10:46,2022,3,EASTERN EUROPE-EU,BULGARIA,2,LIVERPOOL (JOHN LENNON),BURGAS,0,0,0,2802,2802,0,-100
20/03/2023 10:46,2022,3,EASTERN EUROPE-EU,BULGARIA,2,LIVERPOOL (JOHN LENNON),SOFIA,34464,34464,0,13116,13048,68,162.76304
20/03/2023 10:46,2022,3,EASTERN EUROPE-EU,BULGARIA,2,LIVERPOOL (JOHN LENNON),VARNA,18963,18963,0,12205,12205,0,55.37075
20/03/2023 10:46,2022,3,EASTERN EUROPE-EU,BULGARIA,2,MANCHESTER,BURGAS,65373,37934,27439,0,0,0,0
20/03/2023 10:46,2022,3,EASTERN EUROPE-EU,BULGARIA,2,MANCHESTER,SOFIA,67550,60022,7528,19116,18389,727,253.36891
20/03/2023 10:46,2022,3,EASTERN EUROPE-EU,BULGARIA,2,NEWCASTLE,BURGAS,28608,28608,0,0,0,0,0
20/03/2023 10:46,2022,3,EASTERN EUROPE-EU,BULGARIA,2,NEWCASTLE,SOFIA,2827,2827,0,111,111,0,2446.84685
20/03/2023 10:46,2022,3,EASTERN EUROPE-EU,BULGARIA,2,NEWQUAY,SOFIA,0,0,0,147,0,147,-100
20/03/2023 10:46,2022,3,EASTERN EUROPE-EU,BULGARIA,2,NORWICH,BURGAS,1413,0,1413,0,0,0,0
20/03/2023 10:46,2022,3,EASTERN EUROPE-EU,BULGARIA,2,TEESSIDE INTERNATIONAL AIRPORT,BURGAS,4764,0,4764,0,0,0,0
20/03/2023 10:46,2022,3,EASTERN EUROPE-EU,CZECH REPUBLIC,1,GATWICK,KARLOVY VARY,90,0,90,0,0,0,0
20/03/2023 10:46,2022,3,EASTERN EUROPE-EU,CZECH REPUBLIC,1,GATWICK,PRAGUE,108049,108049,0,13536,13478,58,698.23434
20/03/2023 10:46,2022,3,EASTERN EUROPE-EU,CZECH REPUBLIC,1,HEATHROW,PRAGUE,304480,304480,0,53729,53729,0,466.69583
20/03/2023 10:46,2022,3,EASTERN EUROPE-EU,CZECH REPUBLIC,1,LONDON CITY,PRAGUE,4007,4007,0,2036,2036,0,96.80747
20/03/2023 10:46,2022,3,EASTERN EUROPE-EU,CZECH REPUBLIC,1,LUTON,PRAGUE,59085,59085,0,0,0,0,0
20/03/2023 10:46,2022,3,EASTERN EUROPE-EU,CZECH REPUBLIC,1,STANSTED,BRNO (TURANY),94130,94130,0,22799,22799,0,312.86899
20/03/2023 10:46,2022,3,EASTERN EUROPE-EU,CZECH REPUBLIC,1,STANSTED,OSTRAVA,30203,30203,0,10232,10232,0,195.18178
20/03/2023 10:46,2022,3,EASTERN EUROPE-EU,CZECH REPUBLIC,1,STANSTED,PRAGUE,268227,268227,0,115775,115715,60,131.67955
20/03/2023 10:46,2022,3,EASTERN EUROPE-EU,CZECH REPUBLIC,2,BELFAST INTERNATIONAL,OSTRAVA,362,0,362,0,0,0,0
20/03/2023 10:46,2022,3,EASTERN EUROPE-EU,CZECH REPUBLIC,2,BELFAST INTERNATIONAL,PRAGUE,1671,1671,0,564,564,0,196.2766
20/03/2023 10:46,2022,3,EASTERN EUROPE-EU,CZECH REPUBLIC,2,BIGGIN HILL,PRAGUE,10,0,10,4,0,4,150
20/03/2023 10:46,2022,3,EASTERN EUROPE-EU,CZECH REPUBLIC,2,BIRMINGHAM,BRNO (TURANY),180,180,0,0,0,0,0
20/03/2023 10:46,2022,3,EASTERN EUROPE-EU,CZECH REPUBLIC,2,BIRMINGHAM,PRAGUE,47060,46729,331,4672,4672,0,907.2774
20/03/2023 10:46,2022,3,EASTERN EUROPE-EU,CZECH REPUBLIC,2,BRISTOL,PRAGUE,36941,36941,0,9189,9189,0,302.01328
20/03/2023 10:46,2022,3,EASTERN EUROPE-EU,CZECH REPUBLIC,2,CARDIFF WALES,PRAGUE,95,0,95,462,0,462,-79.43723
20/03/2023 10:46,2022,3,EASTERN EUROPE-EU,CZECH REPUBLIC,2,EAST MIDLANDS INTERNATIONAL,PRAGUE,1913,1913,0,554,554,0,245.30686
20/03/2023 10:46,2022,3,EASTERN EUROPE-EU,CZECH REPUBLIC,2,EDINBURGH,PRAGUE,74251,74251,0,18465,18465,0,302.11752
20/03/2023 10:46,2022,3,EASTERN EUROPE-EU,CZECH REPUBLIC,2,GLASGOW,OSTRAVA,62,0,62,0,0,0,0
20/03/2023 10:46,2022,3,EASTERN EUROPE-EU,CZECH REPUBLIC,2,GLASGOW,PRAGUE,14719,14719,0,968,0,968,1420.55785
20/03/2023 10:46,2022,3,EASTERN EUROPE-EU,CZECH REPUBLIC,2,GUERNSEY,PRAGUE,125,125,0,0,0,0,0
20/03/2023 10:46,2022,3,EASTERN EUROPE-EU,CZECH REPUBLIC,2,LEEDS BRADFORD,PRAGUE,21907,21767,140,2681,2681,0,717.12048
20/03/2023 10:46,2022,3,EASTERN EUROPE-EU,CZECH REPUBLIC,2,LIVERPOOL (JOHN LENNON),PRAGUE,0,0,0,86,0,86,-100
20/03/2023 10:46,2022,3,EASTERN EUROPE-EU,CZECH REPUBLIC,2,MANCHESTER,PRAGUE,205399,205399,0,23775,23697,78,763.9285
20/03/2023 10:46,2022,3,EASTERN EUROPE-EU,CZECH REPUBLIC,2,NEWCASTLE,PRAGUE,15135,15135,0,2424,2424,0,524.38119
20/03/2023 10:46,2022,3,EASTERN EUROPE-EU,ESTONIA,1,GATWICK,TALLIN,27625,27625,0,16244,16244,0,70.06279
20/03/2023 10:46,2022,3,EASTERN EUROPE-EU,ESTONIA,1,LUTON,TALLIN,8702,8702,0,0,0,0,0
20/03/2023 10:46,2022,3,EASTERN EUROPE-EU,ESTONIA,1,STANSTED,TALLIN,69236,69236,0,32949,32835,114,110.13081
20/03/2023 10:46,2022,3,EASTERN EUROPE-EU,ESTONIA,2,BELFAST INTERNATIONAL,TALLIN,0,0,0,54,0,54,-100
20/03/2023 10:46,2022,3,EASTERN EUROPE-EU,ESTONIA,2,BIGGIN HILL,TALLIN,3,0,3,0,0,0,0
20/03/2023 10:46,2022,3,EASTERN EUROPE-EU,ESTONIA,2,CARDIFF WALES,TALLIN,0,0,0,403,0,403,-100
20/03/2023 10:46,2022,3,EASTERN EUROPE-EU,ESTONIA,2,EDINBURGH,TALLIN,22943,22943,0,2861,2861,0,701.9224
20/03/2023 10:46,2022,3,EASTERN EUROPE-EU,ESTONIA,2,GLASGOW,TALLIN,0,0,0,70,0,70,-100
20/03/2023 10:46,2022,3,EASTERN EUROPE-EU,ESTONIA,2,LIVERPOOL (JOHN LENNON),TALLIN,20079,20079,0,2407,2407,0,734.19194
20/03/2023 10:46,2022,3,EASTERN EUROPE-EU,HUNGARY,1,GATWICK,BUDAPEST,152971,152971,0,22564,22097,467,577.94274
20/03/2023 10:46,2022,3,EASTERN EUROPE-EU,HUNGARY,1,HEATHROW,BUDAPEST,245247,245247,0,30007,30007,0,717.2993
20/03/2023 10:46,2022,3,EASTERN EUROPE-EU,HUNGARY,1,LUTON,BUDAPEST,363070,363070,0,139563,139491,72,160.14775
20/03/2023 10:46,2022,3,EASTERN EUROPE-EU,HUNGARY,1,LUTON,DEBRECEN,74359,74359,0,20369,20369,0,265.05965
20/03/2023 10:46,2022,3,EASTERN EUROPE-EU,HUNGARY,1,STANSTED,BUDAPEST,479766,479766,0,133998,133764,234,258.03967
20/03/2023 10:46,2022,3,EASTERN EUROPE-EU,HUNGARY,2,BELFAST CITY (GEORGE BEST),BUDAPEST,45,0,45,0,0,0,0
20/03/2023 10:46,2022,3,EASTERN EUROPE-EU,HUNGARY,2,BELFAST INTERNATIONAL,BUDAPEST,39,0,39,0,0,0,0
20/03/2023 10:46,2022,3,EASTERN EUROPE-EU,HUNGARY,2,BIGGIN HILL,BUDAPEST,8,0,8,4,0,4,100
20/03/2023 10:46,2022,3,EASTERN EUROPE-EU,HUNGARY,2,BIRMINGHAM,BUDAPEST,58163,58163,0,8622,8515,107,574.58826
20/03/2023 10:46,2022,3,EASTERN EUROPE-EU,HUNGARY,2,BOURNEMOUTH,BUDAPEST,23463,23463,0,3094,3094,0,658.33872
20/03/2023 10:46,2022,3,EASTERN EUROPE-EU,HUNGARY,2,BRISTOL,BUDAPEST,54133,54133,0,18354,18354,0,194.93843
20/03/2023 10:46,2022,3,EASTERN EUROPE-EU,HUNGARY,2,CARDIFF WALES,BUDAPEST,0,0,0,62,0,62,-100
20/03/2023 10:46,2022,3,EASTERN EUROPE-EU,HUNGARY,2,EAST MIDLANDS INTERNATIONAL,BUDAPEST,36099,36099,0,10651,10651,0,238.92592
20/03/2023 10:46,2022,3,EASTERN EUROPE-EU,HUNGARY,2,EDINBURGH,BUDAPEST,126147,126147,0,28029,28029,0,350.05887
20/03/2023 10:46,2022,3,EASTERN EUROPE-EU,HUNGARY,2,GLASGOW,BUDAPEST,132,132,0,221,0,221,-40.27149
20/03/2023 10:46,2022,3,EASTERN EUROPE-EU,HUNGARY,2,GLASGOW,DEBRECEN,0,0,0,39,0,39,-100
20/03/2023 10:46,2022,3,EASTERN EUROPE-EU,HUNGARY,2,LEEDS BRADFORD,BUDAPEST,20923,20754,169,1121,1121,0,1766.45852
20/03/2023 10:46,2022,3,EASTERN EUROPE-EU,HUNGARY,2,LIVERPOOL (JOHN LENNON),BUDAPEST,26751,26751,0,5881,5612,269,354.87162
20/03/2023 10:46,2022,3,EASTERN EUROPE-EU,HUNGARY,2,MANCHESTER,BUDAPEST,139007,139007,0,37930,37536,394,266.48299
20/03/2023 10:46,2022,3,EASTERN EUROPE-EU,HUNGARY,2,NEWCASTLE,BUDAPEST,1720,1720,0,1251,1251,0,37.49001
20/03/2023 10:46,2022,3,EASTERN EUROPE-EU,HUNGARY,2,PRESTWICK,BUDAPEST,138,0,138,0,0,0,0
20/03/2023 10:46,2022,3,EASTERN EUROPE-EU,LATVIA,1,GATWICK,RIGA,106965,106965,0,39348,39348,0,171.84355
20/03/2023 10:46,2022,3,EASTERN EUROPE-EU,LATVIA,1,LUTON,RIGA,99660,99660,0,28667,28667,0,247.64712
20/03/2023 10:46,2022,3,EASTERN EUROPE-EU,LATVIA,1,STANSTED,RIGA,210716,210716,0,86374,86374,0,143.95767
20/03/2023 10:46,2022,3,EASTERN EUROPE-EU,LATVIA,2,ABERDEEN,RIGA,8178,8178,0,2159,1911,248,278.78648
20/03/2023 10:46,2022,3,EASTERN EUROPE-EU,LATVIA,2,BELFAST INTERNATIONAL,RIGA,238,0,238,0,0,0,0
20/03/2023 10:46,2022,3,EASTERN EUROPE-EU,LATVIA,2,BIGGIN HILL,RIGA,8,0,8,8,0,8,0
20/03/2023 10:46,2022,3,EASTERN EUROPE-EU,LATVIA,2,BIRMINGHAM,RIGA,0,0,0,2103,2062,41,-100
20/03/2023 10:46,2022,3,EASTERN EUROPE-EU,LATVIA,2,BRISTOL,RIGA,28844,28844,0,2522,2522,0,1043.69548
20/03/2023 10:46,2022,3,EASTERN EUROPE-EU,LATVIA,2,DONCASTER SHEFFIELD,RIGA,647,647,0,7791,7791,0,-91.69555
20/03/2023 10:46,2022,3,EASTERN EUROPE-EU,LATVIA,2,EAST MIDLANDS INTERNATIONAL,RIGA,38319,38319,0,14870,14870,0,157.69334
20/03/2023 10:46,2022,3,EASTERN EUROPE-EU,LATVIA,2,EDINBURGH,RIGA,55651,55417,234,17488,17488,0,218.22392
20/03/2023 10:46,2022,3,EASTERN EUROPE-EU,LATVIA,2,LEEDS BRADFORD,RIGA,41712,41712,0,2973,2884,89,1303.02725
20/03/2023 10:46,2022,3,EASTERN EUROPE-EU,LATVIA,2,LIVERPOOL (JOHN LENNON),RIGA,0,0,0,126,126,0,-100
20/03/2023 10:46,2022,3,EASTERN EUROPE-EU,LATVIA,2,MANCHESTER,RIGA,61666,61666,0,23219,23219,0,165.58422
20/03/2023 10:46,2022,3,EASTERN EUROPE-EU,LATVIA,2,NEWCASTLE,RIGA,21398,21398,0,0,0,0,0
20/03/2023 10:46,2022,3,EASTERN EUROPE-EU,LITHUANIA,1,GATWICK,VILNIUS,11045,10664,381,3921,3593,328,181.68834
20/03/2023 10:46,2022,3,EASTERN EUROPE-EU,LITHUANIA,1,HEATHROW,VILNIUS,0,0,0,47,47,0,-100
20/03/2023 10:46,2022,3,EASTERN EUROPE-EU,LITHUANIA,1,LONDON CITY,VILNIUS,38654,38654,0,21507,21507,0,79.72753
20/03/2023 10:46,2022,3,EASTERN EUROPE-EU,LITHUANIA,1,LUTON,KAUNAS,195582,195582,0,84619,84619,0,131.13249
20/03/2023 10:46,2022,3,EASTERN EUROPE-EU,LITHUANIA,1,LUTON,PALANGA,36221,36221,0,8438,8438,0,329.26049
20/03/2023 10:46,2022,3,EASTERN EUROPE-EU,LITHUANIA,1,LUTON,VILNIUS,212367,212367,0,75689,75689,0,180.57842
20/03/2023 10:46,2022,3,EASTERN EUROPE-EU,LITHUANIA,1,SOUTHEND,VILNIUS,0,0,0,78,78,0,-100
20/03/2023 10:46,2022,3,EASTERN EUROPE-EU,LITHUANIA,1,STANSTED,KAUNAS,79454,79454,0,31230,31230,0,154.41563
20/03/2023 10:46,2022,3,EASTERN EUROPE-EU,LITHUANIA,1,STANSTED,PALANGA,46576,46576,0,13243,13243,0,251.70279
20/03/2023 10:46,2022,3,EASTERN EUROPE-EU,LITHUANIA,1,STANSTED,VILNIUS,120084,120084,0,44273,44208,65,171.23529
20/03/2023 10:46,2022,3,EASTERN EUROPE-EU,LITHUANIA,2,BELFAST INTERNATIONAL,VILNIUS,13907,13907,0,873,523,350,1493.0126
20/03/2023 10:46,2022,3,EASTERN EUROPE-EU,LITHUANIA,2,BIGGIN HILL,VILNIUS,1,0,1,4,0,4,-75
20/03/2023 10:46,2022,3,EASTERN EUROPE-EU,LITHUANIA,2,BIRMINGHAM,KAUNAS,449,449,0,0,0,0,0
20/03/2023 10:46,2022,3,EASTERN EUROPE-EU,LITHUANIA,2,BIRMINGHAM,VILNIUS,30180,30180,0,8614,8614,0,250.35988
20/03/2023 10:46,2022,3,EASTERN EUROPE-EU,LITHUANIA,2,BRISTOL,KAUNAS,30396,30396,0,14154,14154,0,114.75201
20/03/2023 10:46,2022,3,EASTERN EUROPE-EU,LITHUANIA,2,DONCASTER SHEFFIELD,VILNIUS,24274,24274,0,9292,9292,0,161.23547
20/03/2023 10:46,2022,3,EASTERN EUROPE-EU,LITHUANIA,2,DUNDEE,KAUNAS,7,0,7,0,0,0,0
20/03/2023 10:46,2022,3,EASTERN EUROPE-EU,LITHUANIA,2,EDINBURGH,KAUNAS,42251,42251,0,14248,14248,0,196.53987
20/03/2023 10:46,2022,3,EASTERN EUROPE-EU,LITHUANIA,2,LEEDS BRADFORD,VILNIUS,38889,38889,0,10514,10514,0,269.87826
20/03/2023 10:46,2022,3,EASTERN EUROPE-EU,LITHUANIA,2,LIVERPOOL (JOHN LENNON),KAUNAS,25206,25206,0,7287,7219,68,245.90366
20/03/2023 10:46,2022,3,EASTERN EUROPE-EU,LITHUANIA,2,LIVERPOOL (JOHN LENNON),VILNIUS,23061,23061,0,12271,12217,54,87.93089
20/03/2023 10:46,2022,3,EASTERN EUROPE-EU,LITHUANIA,2,MANCHESTER,KAUNAS,1650,1650,0,1634,1634,0,0.97919
20/03/2023 10:46,2022,3,EASTERN EUROPE-EU,POLAND,1,GATWICK,GDANSK,0,0,0,216,216,0,-100
20/03/2023 10:46,2022,3,EASTERN EUROPE-EU,POLAND,1,GATWICK,KRAKOW,124296,123680,616,20098,20098,0,518.4496
20/03/2023 10:46,2022,3,EASTERN EUROPE-EU,POLAND,1,GATWICK,LUBLIN (PORT LOTNICZY),272,0,272,0,0,0,0
20/03/2023 10:46,2022,3,EASTERN EUROPE-EU,POLAND,1,GATWICK,RZESZOW,1,0,1,0,0,0,0
20/03/2023 10:46,2022,3,EASTERN EUROPE-EU,POLAND,1,GATWICK,WARSAW (CHOPIN),706,0,706,770,0,770,-8.31169
20/03/2023 10:46,2022,3,EASTERN EUROPE-EU,POLAND,1,HEATHROW,KRAKOW,59838,59838,0,8861,8861,0,575.29624
20/03/2023 10:46,2022,3,EASTERN EUROPE-EU,POLAND,1,HEATHROW,WARSAW (CHOPIN),411685,411597,88,119505,119505,0,244.49186
20/03/2023 10:46,2022,3,EASTERN EUROPE-EU,POLAND,1,LUTON,BYDGOSZCZ,39976,39976,0,13126,13126,0,204.55584
20/03/2023 10:46,2022,3,EASTERN EUROPE-EU,POLAND,1,LUTON,GDANSK,190379,190379,0,82861,82861,0,129.75706
20/03/2023 10:46,2022,3,EASTERN EUROPE-EU,POLAND,1,LUTON,KATOWICE,200572,200572,0,67617,67617,0,196.62955
20/03/2023 10:46,2022,3,EASTERN EUROPE-EU,POLAND,1,LUTON,KRAKOW,304450,304450,0,99705,99705,0,205.35078
20/03/2023 10:46,2022,3,EASTERN EUROPE-EU,POLAND,1,LUTON,LODZ LUBLINEK,1690,1690,0,0,0,0,0
20/03/2023 10:46,2022,3,EASTERN EUROPE-EU,POLAND,1,LUTON,LUBLIN (PORT LOTNICZY),156258,156258,0,35970,35970,0,334.41201
20/03/2023 10:46,2022,3,EASTERN EUROPE-EU,POLAND,1,LUTON,POZNAN,105307,105307,0,41757,41757,0,152.19005
20/03/2023 10:46,2022,3,EASTERN EUROPE-EU,POLAND,1,LUTON,RZESZOW,75977,75977,0,24719,24719,0,207.36276
20/03/2023 10:46,2022,3,EASTERN EUROPE-EU,POLAND,1,LUTON,SZYMANY (MAZURY),22553,22553,0,958,958,0,2254.17537
20/03/2023 10:46,2022,3,EASTERN EUROPE-EU,POLAND,1,LUTON,WARSAW (CHOPIN),342471,342471,0,124017,124017,0,176.14843
20/03/2023 10:46,2022,3,EASTERN EUROPE-EU,POLAND,1,LUTON,WARSAW (MODLIN MASOVIA),159,159,0,0,0,0,0
20/03/2023 10:46,2022,3,EASTERN EUROPE-EU,POLAND,1,LUTON,WROCLAW,115990,115990,0,42251,42251,0,174.52605
20/03/2023 10:46,2022,3,EASTERN EUROPE-EU,POLAND,1,STANSTED,BYDGOSZCZ,64361,64361,0,19717,19717,0,226.4239
20/03/2023 10:46,2022,3,EASTERN EUROPE-EU,POLAND,1,STANSTED,GDANSK,193660,193660,0,69635,69501,134,178.10727
20/03/2023 10:46,2022,3,EASTERN EUROPE-EU,POLAND,1,STANSTED,KATOWICE,148728,148728,0,44177,44177,0,236.66387
20/03/2023 10:46,2022,3,EASTERN EUROPE-EU,POLAND,1,STANSTED,KRAKOW,295090,294721,369,105250,105250,0,180.37055
20/03/2023 10:46,2022,3,EASTERN EUROPE-EU,POLAND,1,STANSTED,LODZ LUBLINEK,81837,81837,0,22936,22936,0,256.80589
20/03/2023 10:46,2022,3,EASTERN EUROPE-EU,POLAND,1,STANSTED,POZNAN,137464,137464,0,45689,45689,0,200.86892
20/03/2023 10:46,2022,3,EASTERN EUROPE-EU,POLAND,1,STANSTED,RZESZOW,117333,117333,0,36471,36471,0,221.71588
20/03/2023 10:46,2022,3,EASTERN EUROPE-EU,POLAND,1,STANSTED,SZCZECIN (GOLENOW),80990,80990,0,30318,30318,0,167.13504
20/03/2023 10:46,2022,3,EASTERN EUROPE-EU,POLAND,1,STANSTED,SZYMANY (MAZURY),28401,28401,0,10707,10707,0,165.25637
20/03/2023 10:46,2022,3,EASTERN EUROPE-EU,POLAND,1,STANSTED,WARSAW (CHOPIN),0,0,0,177,163,14,-100
20/03/2023 10:46,2022,3,EASTERN EUROPE-EU,POLAND,1,STANSTED,WARSAW (MODLIN MASOVIA),322116,322116,0,112224,112224,0,187.02951
20/03/2023 10:46,2022,3,EASTERN EUROPE-EU,POLAND,1,STANSTED,WROCLAW,167472,167472,0,64182,64182,0,160.93297
20/03/2023 10:46,2022,3,EASTERN EUROPE-EU,POLAND,2,ABERDEEN,GDANSK,30658,30658,0,7738,7513,225,296.20057
20/03/2023 10:46,2022,3,EASTERN EUROPE-EU,POLAND,2,BELFAST INTERNATIONAL,GDANSK,0,0,0,5108,5108,0,-100
20/03/2023 10:46,2022,3,EASTERN EUROPE-EU,POLAND,2,BELFAST INTERNATIONAL,KRAKOW,17771,17771,0,6836,6836,0,159.96197
20/03/2023 10:46,2022,3,EASTERN EUROPE-EU,POLAND,2,BELFAST INTERNATIONAL,WARSAW (MODLIN MASOVIA),0,0,0,4758,4758,0,-100
20/03/2023 10:46,2022,3,EASTERN EUROPE-EU,POLAND,2,BIGGIN HILL,GDANSK,0,0,0,2,0,2,-100
20/03/2023 10:46,2022,3,EASTERN EUROPE-EU,POLAND,2,BIGGIN HILL,KATOWICE,0,0,0,20,0,20,-100
20/03/2023 10:46,2022,3,EASTERN EUROPE-EU,POLAND,2,BIGGIN HILL,KRAKOW,7,0,7,0,0,0,0
20/03/2023 10:46,2022,3,EASTERN EUROPE-EU,POLAND,2,BIGGIN HILL,SZCZECIN (GOLENOW),0,0,0,1,0,1,-100
20/03/2023 10:46,2022,3,EASTERN EUROPE-EU,POLAND,2,BIGGIN HILL,WARSAW (CHOPIN),4,0,4,1,0,1,300
20/03/2023 10:46,2022,3,EASTERN EUROPE-EU,POLAND,2,BIRMINGHAM,BYDGOSZCZ,48148,48148,0,19636,19563,73,145.20269
20/03/2023 10:46,2022,3,EASTERN EUROPE-EU,POLAND,2,BIRMINGHAM,GDANSK,32830,32830,0,13238,13238,0,147.99819
20/03/2023 10:46,2022,3,EASTERN EUROPE-EU,POLAND,2,BIRMINGHAM,KATOWICE,4680,4680,0,11053,11053,0,-57.65855
20/03/2023 10:46,2022,3,EASTERN EUROPE-EU,POLAND,2,BIRMINGHAM,KRAKOW,95006,95006,0,31435,31435,0,202.23
20/03/2023 10:46,2022,3,EASTERN EUROPE-EU,POLAND,2,BIRMINGHAM,POZNAN,29930,29930,0,9109,9109,0,228.57613
20/03/2023 10:46,2022,3,EASTERN EUROPE-EU,POLAND,2,BIRMINGHAM,RZESZOW,170,170,0,0,0,0,0
20/03/2023 10:46,2022,3,EASTERN EUROPE-EU,POLAND,2,BIRMINGHAM,WARSAW (CHOPIN),32092,31782,310,9278,9278,0,245.89351
20/03/2023 10:46,2022,3,EASTERN EUROPE-EU,POLAND,2,BIRMINGHAM,WARSAW (MODLIN MASOVIA),48650,48650,0,14528,14528,0,234.87059
20/03/2023 10:46,2022,3,EASTERN EUROPE-EU,POLAND,2,BIRMINGHAM,WROCLAW,16046,16046,0,4192,4192,0,282.77672
20/03/2023 10:46,2022,3,EASTERN EUROPE-EU,POLAND,2,BOURNEMOUTH,KATOWICE,0,0,0,142,142,0,-100
20/03/2023 10:46,2022,3,EASTERN EUROPE-EU,POLAND,2,BOURNEMOUTH,KRAKOW,34815,34815,0,13640,13640,0,155.24194
20/03/2023 10:46,2022,3,EASTERN EUROPE-EU,POLAND,2,BOURNEMOUTH,WROCLAW,28972,28972,0,2499,2499,0,1059.34374
20/03/2023 10:46,2022,3,EASTERN EUROPE-EU,POLAND,2,BRISTOL,BYDGOSZCZ,4874,4874,0,0,0,0,0
20/03/2023 10:46,2022,3,EASTERN EUROPE-EU,POLAND,2,BRISTOL,GDANSK,33135,33135,0,14293,14293,0,131.82677
20/03/2023 10:46,2022,3,EASTERN EUROPE-EU,POLAND,2,BRISTOL,KATOWICE,25749,25749,0,9004,9004,0,185.9729
20/03/2023 10:46,2022,3,EASTERN EUROPE-EU,POLAND,2,BRISTOL,KRAKOW,83218,83218,0,33717,33717,0,146.81318
20/03/2023 10:46,2022,3,EASTERN EUROPE-EU,POLAND,2,BRISTOL,POZNAN,42222,42222,0,12932,12932,0,226.49242
20/03/2023 10:46,2022,3,EASTERN EUROPE-EU,POLAND,2,BRISTOL,RZESZOW,30937,30937,0,3410,3410,0,807.2434
20/03/2023 10:46,2022,3,EASTERN EUROPE-EU,POLAND,2,BRISTOL,WARSAW (MODLIN MASOVIA),39580,39580,0,19895,19895,0,98.94446
20/03/2023 10:46,2022,3,EASTERN EUROPE-EU,POLAND,2,BRISTOL,WROCLAW,31937,31937,0,12936,12936,0,146.88466
20/03/2023 10:46,2022,3,EASTERN EUROPE-EU,POLAND,2,CARDIFF WALES,KATOWICE,0,0,0,76,76,0,-100
20/03/2023 10:46,2022,3,EASTERN EUROPE-EU,POLAND,2,CARDIFF WALES,WARSAW (CHOPIN),162,0,162,0,0,0,0
20/03/2023 10:46,2022,3,EASTERN EUROPE-EU,POLAND,2,CARDIFF WALES,WROCLAW,434,0,434,0,0,0,0
20/03/2023 10:46,2022,3,EASTERN EUROPE-EU,POLAND,2,DONCASTER SHEFFIELD,GDANSK,38050,38050,0,16141,16141,0,135.73508
20/03/2023 10:46,2022,3,EASTERN EUROPE-EU,POLAND,2,DONCASTER SHEFFIELD,KATOWICE,36627,36627,0,10413,10413,0,251.74301
20/03/2023 10:46,2022,3,EASTERN EUROPE-EU,POLAND,2,DONCASTER SHEFFIELD,KRAKOW,31357,31357,0,9235,9235,0,239.54521
20/03/2023 10:46,2022,3,EASTERN EUROPE-EU,POLAND,2,DONCASTER SHEFFIELD,LUBLIN (PORT LOTNICZY),426,426,0,7427,7427,0,-94.26417
20/03/2023 10:46,2022,3,EASTERN EUROPE-EU,POLAND,2,DONCASTER SHEFFIELD,POZNAN,7717,7717,0,10601,10601,0,-27.20498
20/03/2023 10:46,2022,3,EASTERN EUROPE-EU,POLAND,2,DONCASTER SHEFFIELD,WARSAW (CHOPIN),39536,39536,0,21785,21785,0,81.48267
20/03/2023 10:46,2022,3,EASTERN EUROPE-EU,POLAND,2,DONCASTER SHEFFIELD,WROCLAW,20344,20344,0,6374,6374,0,219.17163
20/03/2023 10:46,2022,3,EASTERN EUROPE-EU,POLAND,2,EAST MIDLANDS INTERNATIONAL,KRAKOW,46070,46070,0,12066,12066,0,281.81667
20/03/2023 10:46,2022,3,EASTERN EUROPE-EU,POLAND,2,EAST MIDLANDS INTERNATIONAL,LODZ LUBLINEK,4552,4552,0,12859,12859,0,-64.60067
20/03/2023 10:46,2022,3,EASTERN EUROPE-EU,POLAND,2,EAST MIDLANDS INTERNATIONAL,RZESZOW,28618,28618,0,14998,14998,0,90.81211
20/03/2023 10:46,2022,3,EASTERN EUROPE-EU,POLAND,2,EAST MIDLANDS INTERNATIONAL,WARSAW (CHOPIN),0,0,0,163,0,163,-100
20/03/2023 10:46,2022,3,EASTERN EUROPE-EU,POLAND,2,EAST MIDLANDS INTERNATIONAL,WARSAW (MODLIN MASOVIA),4662,4662,0,12150,12150,0,-61.62963
20/03/2023 10:46,2022,3,EASTERN EUROPE-EU,POLAND,2,EAST MIDLANDS INTERNATIONAL,WROCLAW,39356,39356,0,19809,19809,0,98.67737
20/03/2023 10:46,2022,3,EASTERN EUROPE-EU,POLAND,2,EDINBURGH,GDANSK,91961,91961,0,24094,24094,0,281.67594
20/03/2023 10:46,2022,3,EASTERN EUROPE-EU,POLAND,2,EDINBURGH,KATOWICE,15135,15135,0,11375,11375,0,33.05495
20/03/2023 10:46,2022,3,EASTERN EUROPE-EU,POLAND,2,EDINBURGH,KRAKOW,121364,121010,354,35287,35287,0,243.93403
20/03/2023 10:46,2022,3,EASTERN EUROPE-EU,POLAND,2,EDINBURGH,POZNAN,42358,42358,0,13272,13272,0,219.1531
20/03/2023 10:46,2022,3,EASTERN EUROPE-EU,POLAND,2,EDINBURGH,RZESZOW,19,0,19,0,0,0,0
20/03/2023 10:46,2022,3,EASTERN EUROPE-EU,POLAND,2,EDINBURGH,WARSAW (CHOPIN),30202,30202,0,1985,1985,0,1421.51134
20/03/2023 10:46,2022,3,EASTERN EUROPE-EU,POLAND,2,EDINBURGH,WARSAW (MODLIN MASOVIA),71456,71456,0,28017,28017,0,155.04515
20/03/2023 10:46,2022,3,EASTERN EUROPE-EU,POLAND,2,EDINBURGH,WROCLAW,43235,43235,0,10512,10512,0,311.29186
20/03/2023 10:46,2022,3,EASTERN EUROPE-EU,POLAND,2,EXETER,KRAKOW,0,0,0,132,132,0,-100
20/03/2023 10:46,2022,3,EASTERN EUROPE-EU,POLAND,2,GLASGOW,KATOWICE,193,0,193,0,0,0,0
20/03/2023 10:46,2022,3,EASTERN EUROPE-EU,POLAND,2,GLASGOW,KRAKOW,33995,33995,0,12048,12048,0,182.16301
20/03/2023 10:46,2022,3,EASTERN EUROPE-EU,POLAND,2,GLASGOW,LODZ LUBLINEK,55,0,55,0,0,0,0
20/03/2023 10:46,2022,3,EASTERN EUROPE-EU,POLAND,2,GLASGOW,RZESZOW,170,0,170,0,0,0,0
20/03/2023 10:46,2022,3,EASTERN EUROPE-EU,POLAND,2,GLASGOW,WARSAW (CHOPIN),345,0,345,0,0,0,0
20/03/2023 10:46,2022,3,EASTERN EUROPE-EU,POLAND,2,GLASGOW,WARSAW (MODLIN MASOVIA),30751,30379,372,6778,6778,0,353.6884
20/03/2023 10:46,2022,3,EASTERN EUROPE-EU,POLAND,2,GLASGOW,WROCLAW,22017,22017,0,9966,9966,0,120.92113
20/03/2023 10:46,2022,3,EASTERN EUROPE-EU,POLAND,2,LEEDS BRADFORD,GDANSK,51142,51142,0,13216,13114,102,286.97034
20/03/2023 10:46,2022,3,EASTERN EUROPE-EU,POLAND,2,LEEDS BRADFORD,KATOWICE,6112,6112,0,0,0,0,0
20/03/2023 10:46,2022,3,EASTERN EUROPE-EU,POLAND,2,LEEDS BRADFORD,KRAKOW,70335,70335,0,23341,23341,0,201.3367
20/03/2023 10:46,2022,3,EASTERN EUROPE-EU,POLAND,2,LEEDS BRADFORD,POZNAN,24638,24638,0,645,645,0,3719.84496
20/03/2023 10:46,2022,3,EASTERN EUROPE-EU,POLAND,2,LEEDS BRADFORD,WARSAW (CHOPIN),7373,7373,0,0,0,0,0
20/03/2023 10:46,2022,3,EASTERN EUROPE-EU,POLAND,2,LEEDS BRADFORD,WARSAW (MODLIN MASOVIA),49381,49381,0,12078,12078,0,308.8508
20/03/2023 10:46,2022,3,EASTERN EUROPE-EU,POLAND,2,LEEDS BRADFORD,WROCLAW,32832,32832,0,8308,8308,0,295.18536
20/03/2023 10:46,2022,3,EASTERN EUROPE-EU,POLAND,2,LIVERPOOL (JOHN LENNON),GDANSK,30104,30104,0,10026,10026,0,200.25933
20/03/2023 10:46,2022,3,EASTERN EUROPE-EU,POLAND,2,LIVERPOOL (JOHN LENNON),KATOWICE,22912,22912,0,2643,2643,0,766.89368
20/03/2023 10:46,2022,3,EASTERN EUROPE-EU,POLAND,2,LIVERPOOL (JOHN LENNON),KRAKOW,73898,73898,0,23354,23354,0,216.42545
20/03/2023 10:46,2022,3,EASTERN EUROPE-EU,POLAND,2,LIVERPOOL (JOHN LENNON),LODZ LUBLINEK,49,0,49,0,0,0,0
20/03/2023 10:46,2022,3,EASTERN EUROPE-EU,POLAND,2,LIVERPOOL (JOHN LENNON),LUBLIN (PORT LOTNICZY),1,1,0,0,0,0,0
20/03/2023 10:46,2022,3,EASTERN EUROPE-EU,POLAND,2,LIVERPOOL (JOHN LENNON),POZNAN,38827,38827,0,11435,11435,0,239.54526
20/03/2023 10:46,2022,3,EASTERN EUROPE-EU,POLAND,2,LIVERPOOL (JOHN LENNON),SZCZECIN (GOLENOW),9874,9874,0,12481,12481,0,-20.88775
20/03/2023 10:46,2022,3,EASTERN EUROPE-EU,POLAND,2,LIVERPOOL (JOHN LENNON),WARSAW (CHOPIN),33899,33899,0,10720,10720,0,216.22201
20/03/2023 10:46,2022,3,EASTERN EUROPE-EU,POLAND,2,LIVERPOOL (JOHN LENNON),WARSAW (MODLIN MASOVIA),46869,46869,0,18590,18590,0,152.11942
20/03/2023 10:46,2022,3,EASTERN EUROPE-EU,POLAND,2,LIVERPOOL (JOHN LENNON),WROCLAW,30610,30610,0,10724,10724,0,185.43454
20/03/2023 10:46,2022,3,EASTERN EUROPE-EU,POLAND,2,MANCHESTER,GDANSK,48544,48544,0,18895,18105,790,156.91453
20/03/2023 10:46,2022,3,EASTERN EUROPE-EU,POLAND,2,MANCHESTER,KATOWICE,39200,39200,0,15515,15515,0,152.65872
20/03/2023 10:46,2022,3,EASTERN EUROPE-EU,POLAND,2,MANCHESTER,KRAKOW,124498,124144,354,44341,44341,0,180.774
20/03/2023 10:46,2022,3,EASTERN EUROPE-EU,POLAND,2,MANCHESTER,POZNAN,25961,25961,0,2512,2512,0,933.4793
20/03/2023 10:46,2022,3,EASTERN EUROPE-EU,POLAND,2,MANCHESTER,RZESZOW,28450,28450,0,11715,11715,0,142.85105
20/03/2023 10:46,2022,3,EASTERN EUROPE-EU,POLAND,2,MANCHESTER,WARSAW (MODLIN MASOVIA),43201,43201,0,15477,15477,0,179.13032
20/03/2023 10:46,2022,3,EASTERN EUROPE-EU,POLAND,2,MANCHESTER,WROCLAW,29937,29937,0,15151,15151,0,97.59092
20/03/2023 10:46,2022,3,EASTERN EUROPE-EU,POLAND,2,NEWCASTLE,GDANSK,34351,34266,85,6030,6030,0,469.66833
20/03/2023 10:46,2022,3,EASTERN EUROPE-EU,POLAND,2,NEWCASTLE,KRAKOW,56151,56151,0,9636,9636,0,482.72105
20/03/2023 10:46,2022,3,EASTERN EUROPE-EU,POLAND,2,NEWCASTLE,WROCLAW,25377,25377,0,7594,7594,0,234.17171
20/03/2023 10:46,2022,3,EASTERN EUROPE-EU,POLAND,2,PRESTWICK,KRAKOW,0,0,0,147,0,147,-100
20/03/2023 10:46,2022,3,EASTERN EUROPE-EU,ROMANIA,1,GATWICK,BUCHAREST (OTOPENI),94652,93826,826,4221,3205,1016,2142.40701
20/03/2023 10:46,2022,3,EASTERN EUROPE-EU,ROMANIA,1,HEATHROW,BUCHAREST (OTOPENI),282467,282467,0,142185,142171,14,98.6616
20/03/2023 10:46,2022,3,EASTERN EUROPE-EU,ROMANIA,1,HEATHROW,CLUJ NAPOCA,0,0,0,4872,4872,0,-100
20/03/2023 10:46,2022,3,EASTERN EUROPE-EU,ROMANIA,1,HEATHROW,IASI,675,675,0,7612,7612,0,-91.13242
20/03/2023 10:46,2022,3,EASTERN EUROPE-EU,ROMANIA,1,LONDON CITY,BUCHAREST (OTOPENI),0,0,0,91,0,91,-100
20/03/2023 10:46,2022,3,EASTERN EUROPE-EU,ROMANIA,1,LUTON,BACAU,199213,199213,0,118006,118006,0,68.81599
20/03/2023 10:46,2022,3,EASTERN EUROPE-EU,ROMANIA,1,LUTON,BUCHAREST (BANEASA),226,0,226,0,0,0,0
20/03/2023 10:46,2022,3,EASTERN EUROPE-EU,ROMANIA,1,LUTON,BUCHAREST (OTOPENI),457368,457194,174,228310,228310,0,100.32762
20/03/2023 10:46,2022,3,EASTERN EUROPE-EU,ROMANIA,1,LUTON,CLUJ NAPOCA,249413,249413,0,111672,111672,0,123.34426
20/03/2023 10:46,2022,3,EASTERN EUROPE-EU,ROMANIA,1,LUTON,CONSTANTA,29167,29167,0,20119,20119,0,44.97241
20/03/2023 10:46,2022,3,EASTERN EUROPE-EU,ROMANIA,1,LUTON,CRAIOVA,137210,137210,0,64329,64329,0,113.29416
20/03/2023 10:46,2022,3,EASTERN EUROPE-EU,ROMANIA,1,LUTON,IASI,269580,269580,0,90448,90448,0,198.04971
20/03/2023 10:46,2022,3,EASTERN EUROPE-EU,ROMANIA,1,LUTON,SATU MARE,29157,29157,0,18759,18687,72,55.42939
20/03/2023 10:46,2022,3,EASTERN EUROPE-EU,ROMANIA,1,LUTON,SIBIU,85904,85904,0,41009,41009,0,109.47597
20/03/2023 10:46,2022,3,EASTERN EUROPE-EU,ROMANIA,1,LUTON,SUCEAVA,162827,162827,0,83237,83237,0,95.61854
20/03/2023 10:46,2022,3,EASTERN EUROPE-EU,ROMANIA,1,LUTON,TIMISOARA,113318,113318,0,42396,42396,0,167.28465
20/03/2023 10:46,2022,3,EASTERN EUROPE-EU,ROMANIA,1,LUTON,TIRGU MURES,29007,29007,0,13235,13235,0,119.16887
20/03/2023 10:46,2022,3,EASTERN EUROPE-EU,ROMANIA,1,SOUTHEND,BACAU,324,324,0,0,0,0,0
20/03/2023 10:46,2022,3,EASTERN EUROPE-EU,ROMANIA,1,SOUTHEND,BUCHAREST (BANEASA),46,0,46,0,0,0,0
20/03/2023 10:46,2022,3,EASTERN EUROPE-EU,ROMANIA,1,SOUTHEND,BUCHAREST (OTOPENI),635,635,0,12326,12326,0,-94.84829
20/03/2023 10:46,2022,3,EASTERN EUROPE-EU,ROMANIA,1,SOUTHEND,IASI,21,21,0,0,0,0,0
20/03/2023 10:46,2022,3,EASTERN EUROPE-EU,ROMANIA,1,STANSTED,BUCHAREST (OTOPENI),364025,363911,114,145772,145772,0,149.72217
20/03/2023 10:46,2022,3,EASTERN EUROPE-EU,ROMANIA,1,STANSTED,CLUJ NAPOCA,54936,54936,0,22499,22499,0,144.17085
20/03/2023 10:46,2022,3,EASTERN EUROPE-EU,ROMANIA,1,STANSTED,ORADEA,30995,30995,0,11463,11463,0,170.3917
20/03/2023 10:46,2022,3,EASTERN EUROPE-EU,ROMANIA,1,STANSTED,TIMISOARA,0,0,0,89,89,0,-100
20/03/2023 10:46,2022,3,EASTERN EUROPE-EU,ROMANIA,2,BIGGIN HILL,BUCHAREST (OTOPENI),3,0,3,4,0,4,-25
20/03/2023 10:46,2022,3,EASTERN EUROPE-EU,ROMANIA,2,BIRMINGHAM,BUCHAREST (OTOPENI),146024,146024,0,67885,67885,0,115.10496
20/03/2023 10:46,2022,3,EASTERN EUROPE-EU,ROMANIA,2,BIRMINGHAM,CLUJ NAPOCA,29438,29438,0,9612,9612,0,206.263
20/03/2023 10:46,2022,3,EASTERN EUROPE-EU,ROMANIA,2,BIRMINGHAM,CRAIOVA,42785,42785,0,14192,14192,0,201.47266
20/03/2023 10:46,2022,3,EASTERN EUROPE-EU,ROMANIA,2,BIRMINGHAM,IASI,564,564,0,6623,6623,0,-91.48422
20/03/2023 10:46,2022,3,EASTERN EUROPE-EU,ROMANIA,2,BRISTOL,BUCHAREST (OTOPENI),36279,36279,0,19248,19248,0,88.48192
20/03/2023 10:46,2022,3,EASTERN EUROPE-EU,ROMANIA,2,CARDIFF WALES,BUCHAREST (OTOPENI),1770,1770,0,0,0,0,0
20/03/2023 10:46,2022,3,EASTERN EUROPE-EU,ROMANIA,2,DONCASTER SHEFFIELD,BUCHAREST (OTOPENI),60400,60400,0,51320,51320,0,17.69291
20/03/2023 10:46,2022,3,EASTERN EUROPE-EU,ROMANIA,2,DONCASTER SHEFFIELD,CLUJ NAPOCA,27880,27880,0,18516,18516,0,50.57248
20/03/2023 10:46,2022,3,EASTERN EUROPE-EU,ROMANIA,2,DONCASTER SHEFFIELD,CRAIOVA,0,0,0,291,0,291,-100
20/03/2023 10:46,2022,3,EASTERN EUROPE-EU,ROMANIA,2,DONCASTER SHEFFIELD,SUCEAVA,434,434,0,1042,1042,0,-58.34933
20/03/2023 10:46,2022,3,EASTERN EUROPE-EU,ROMANIA,2,EAST MIDLANDS INTERNATIONAL,CRAIOVA,0,0,0,69,0,69,-100
20/03/2023 10:46,2022,3,EASTERN EUROPE-EU,ROMANIA,2,EDINBURGH,BUCHAREST (OTOPENI),77262,77262,0,30669,30669,0,151.92214
20/03/2023 10:46,2022,3,EASTERN EUROPE-EU,ROMANIA,2,EXETER,CONSTANTA,0,0,0,135,0,135,-100
20/03/2023 10:46,2022,3,EASTERN EUROPE-EU,ROMANIA,2,GLASGOW,BUCHAREST (BANEASA),0,0,0,59,0,59,-100
20/03/2023 10:46,2022,3,EASTERN EUROPE-EU,ROMANIA,2,LEEDS BRADFORD,BUCHAREST (OTOPENI),11519,11519,0,0,0,0,0
20/03/2023 10:46,2022,3,EASTERN EUROPE-EU,ROMANIA,2,LEEDS BRADFORD,CLUJ NAPOCA,6344,6344,0,0,0,0,0
20/03/2023 10:46,2022,3,EASTERN EUROPE-EU,ROMANIA,2,LIVERPOOL (JOHN LENNON),BACAU,31786,31786,0,10977,10977,0,189.5691
20/03/2023 10:46,2022,3,EASTERN EUROPE-EU,ROMANIA,2,LIVERPOOL (JOHN LENNON),BUCHAREST (OTOPENI),52704,52704,0,38269,38190,79,37.71983
20/03/2023 10:46,2022,3,EASTERN EUROPE-EU,ROMANIA,2,LIVERPOOL (JOHN LENNON),CLUJ NAPOCA,15116,15116,0,781,781,0,1835.46735
20/03/2023 10:46,2022,3,EASTERN EUROPE-EU,ROMANIA,2,LIVERPOOL (JOHN LENNON),CRAIOVA,137,137,0,0,0,0,0
20/03/2023 10:46,2022,3,EASTERN EUROPE-EU,ROMANIA,2,LIVERPOOL (JOHN LENNON),IASI,33488,33488,0,12148,12148,0,175.66678
20/03/2023 10:46,2022,3,EASTERN EUROPE-EU,ROMANIA,2,LIVERPOOL (JOHN LENNON),SIBIU,18945,18922,23,1453,1453,0,1203.85409
20/03/2023 10:46,2022,3,EASTERN EUROPE-EU,ROMANIA,2,MANCHESTER,BUCHAREST (OTOPENI),46824,46824,0,19728,19728,0,137.34793
20/03/2023 10:46,2022,3,EASTERN EUROPE-EU,ROMANIA,2,MANCHESTER,SUCEAVA,25055,25055,0,1060,1060,0,2263.67925
20/03/2023 10:46,2022,3,EASTERN EUROPE-EU,ROMANIA,2,NEWCASTLE,BUCHAREST (OTOPENI),18,0,18,0,0,0,0
20/03/2023 10:46,2022,3,EASTERN EUROPE-EU,ROMANIA,2,TEESSIDE INTERNATIONAL AIRPORT,BUCHAREST (OTOPENI),0,0,0,99,0,99,-100
20/03/2023 10:46,2022,3,EASTERN EUROPE-EU,SLOVAK REPUBLIC,1,LUTON,BRATISLAVA,64049,64049,0,13036,13036,0,391.32403
20/03/2023 10:46,2022,3,EASTERN EUROPE-EU,SLOVAK REPUBLIC,1,LUTON,KOSICE,82992,82992,0,38275,38275,0,116.83083
20/03/2023 10:46,2022,3,EASTERN EUROPE-EU,SLOVAK REPUBLIC,1,LUTON,TATRY-POPRAD,30427,30427,0,8096,8096,0,275.82757
20/03/2023 10:46,2022,3,EASTERN EUROPE-EU,SLOVAK REPUBLIC,1,STANSTED,BRATISLAVA,98914,98914,0,42130,42130,0,134.78282
20/03/2023 10:46,2022,3,EASTERN EUROPE-EU,SLOVAK REPUBLIC,1,STANSTED,KOSICE,63541,63541,0,14187,14187,0,347.88186
20/03/2023 10:46,2022,3,EASTERN EUROPE-EU,SLOVAK REPUBLIC,2,ABERDEEN,BRATISLAVA,0,0,0,89,0,89,-100
20/03/2023 10:46,2022,3,EASTERN EUROPE-EU,SLOVAK REPUBLIC,2,BELFAST INTERNATIONAL,BRATISLAVA,81,0,81,0,0,0,0
20/03/2023 10:46,2022,3,EASTERN EUROPE-EU,SLOVAK REPUBLIC,2,BIGGIN HILL,KOSICE,6,0,6,0,0,0,0
20/03/2023 10:46,2022,3,EASTERN EUROPE-EU,SLOVAK REPUBLIC,2,BIRMINGHAM,BRATISLAVA,6105,6105,0,11736,11736,0,-47.98057
20/03/2023 10:46,2022,3,EASTERN EUROPE-EU,SLOVAK REPUBLIC,2,CARDIFF WALES,BRATISLAVA,0,0,0,62,0,62,-100
20/03/2023 10:46,2022,3,EASTERN EUROPE-EU,SLOVAK REPUBLIC,2,CITY OF DERRY (EGLINTON),BRATISLAVA,81,0,81,0,0,0,0
20/03/2023 10:46,2022,3,EASTERN EUROPE-EU,SLOVAK REPUBLIC,2,DONCASTER SHEFFIELD,KOSICE,712,712,0,15024,15024,0,-95.26092
20/03/2023 10:46,2022,3,EASTERN EUROPE-EU,SLOVAK REPUBLIC,2,EDINBURGH,BRATISLAVA,26654,26654,0,5659,5659,0,371.00194
20/03/2023 10:46,2022,3,EASTERN EUROPE-EU,SLOVAK REPUBLIC,2,GLASGOW,BRATISLAVA,5,0,5,0,0,0,0
20/03/2023 10:46,2022,3,EASTERN EUROPE-EU,SLOVAK REPUBLIC,2,LEEDS BRADFORD,BRATISLAVA,28035,28035,0,5660,5660,0,395.31802
20/03/2023 10:46,2022,3,EASTERN EUROPE-EU,SLOVAK REPUBLIC,2,LIVERPOOL (JOHN LENNON),BRATISLAVA,120,120,0,0,0,0,0
20/03/2023 10:46,2022,3,EASTERN EUROPE-EU,SLOVAK REPUBLIC,2,LIVERPOOL (JOHN LENNON),KOSICE,31622,31622,0,7839,7839,0,303.39329
20/03/2023 10:46,2022,3,EASTERN EUROPE-EU,SLOVAK REPUBLIC,2,MANCHESTER,BRATISLAVA,41317,41317,0,11528,11528,0,258.40562
20/03/2023 10:46,2022,4,EASTERN EUROPE -OTHER,ALBANIA,1,GATWICK,TIRANA,50992,48562,2430,15382,14491,891,231.50436
20/03/2023 10:46,2022,4,EASTERN EUROPE -OTHER,ALBANIA,1,HEATHROW,TIRANA,97392,97392,0,71964,71964,0,35.33433
20/03/2023 10:46,2022,4,EASTERN EUROPE -OTHER,ALBANIA,1,LUTON,TIRANA,289255,289255,0,131597,131597,0,119.80364
20/03/2023 10:46,2022,4,EASTERN EUROPE -OTHER,ALBANIA,1,STANSTED,TIRANA,28602,28414,188,5129,5129,0,457.65256
20/03/2023 10:46,2022,4,EASTERN EUROPE -OTHER,ALBANIA,2,BIRMINGHAM,TIRANA,442,0,442,748,0,748,-40.90909
20/03/2023 10:46,2022,4,EASTERN EUROPE -OTHER,ALBANIA,2,LIVERPOOL (JOHN LENNON),TIRANA,20552,20552,0,1372,1372,0,1397.95918
20/03/2023 10:46,2022,4,EASTERN EUROPE -OTHER,ARMENIA,2,GLASGOW,YEREVAN,99,0,99,130,0,130,-23.84615
20/03/2023 10:46,2022,4,EASTERN EUROPE -OTHER,ARMENIA,2,MANCHESTER,YEREVAN,0,0,0,53,0,53,-100
20/03/2023 10:46,2022,4,EASTERN EUROPE -OTHER,AZERBAIJAN,1,HEATHROW,BAKU (HEYDER ALIYEV INT'L),33801,33128,673,10841,9804,1037,211.78858
20/03/2023 10:46,2022,4,EASTERN EUROPE -OTHER,AZERBAIJAN,2,ABERDEEN,BAKU (HEYDER ALIYEV INT'L),0,0,0,88,0,88,-100
20/03/2023 10:46,2022,4,EASTERN EUROPE -OTHER,AZERBAIJAN,2,BIRMINGHAM,BAKU (HEYDER ALIYEV INT'L),0,0,0,525,0,525,-100
20/03/2023 10:46,2022,4,EASTERN EUROPE -OTHER,AZERBAIJAN,2,CARDIFF WALES,BAKU (HEYDER ALIYEV INT'L),0,0,0,225,0,225,-100
20/03/2023 10:46,2022,4,EASTERN EUROPE -OTHER,BELARUS,1,GATWICK,MINSK INT'L ,0,0,0,6031,6031,0,-100
20/03/2023 10:46,2022,4,EASTERN EUROPE -OTHER,GEORGIA,2,BIGGIN HILL,BATUMI ,24,0,24,0,0,0,0
20/03/2023 10:46,2022,4,EASTERN EUROPE -OTHER,KAZAKHSTAN,1,HEATHROW,AKTAU,12490,12490,0,0,0,0,0
20/03/2023 10:46,2022,4,EASTERN EUROPE -OTHER,KAZAKHSTAN,1,HEATHROW,ALMATY,14541,14541,0,0,0,0,0
20/03/2023 10:46,2022,4,EASTERN EUROPE -OTHER,KAZAKHSTAN,1,HEATHROW,NURSULTAN NAZERBAYEV INTERNATIONAL,3234,3234,0,3651,3651,0,-11.42153
20/03/2023 10:46,2022,4,EASTERN EUROPE -OTHER,REPUBLIC OF MOLDOVA,1,LUTON,CHISINAU (KISHINEV),116936,116936,0,135991,135991,0,-14.01196
20/03/2023 10:46,2022,4,EASTERN EUROPE -OTHER,REPUBLIC OF MOLDOVA,1,STANSTED,CHISINAU (KISHINEV),47584,47584,0,27182,27182,0,75.05702
20/03/2023 10:46,2022,4,EASTERN EUROPE -OTHER,REPUBLIC OF MOLDOVA,2,ABERDEEN,CHISINAU (KISHINEV),0,0,0,376,0,376,-100
20/03/2023 10:46,2022,4,EASTERN EUROPE -OTHER,REPUBLIC OF MOLDOVA,2,EDINBURGH,CHISINAU (KISHINEV),0,0,0,364,0,364,-100
20/03/2023 10:46,2022,4,EASTERN EUROPE -OTHER,REPUBLIC OF MOLDOVA,2,GLASGOW,CHISINAU (KISHINEV),0,0,0,440,0,440,-100
20/03/2023 10:46,2022,4,EASTERN EUROPE -OTHER,REPUBLIC OF MOLDOVA,2,LIVERPOOL (JOHN LENNON),CHISINAU (KISHINEV),1247,1247,0,10688,10654,34,-88.33271
20/03/2023 10:46,2022,4,EASTERN EUROPE -OTHER,REPUBLIC OF MOLDOVA,2,MANCHESTER,CHISINAU (KISHINEV),69,0,69,0,0,0,0
20/03/2023 10:46,2022,4,EASTERN EUROPE -OTHER,RUSSIA,1,GATWICK,ST PETERSBURG,0,0,0,424,0,424,-100
20/03/2023 10:46,2022,4,EASTERN EUROPE -OTHER,RUSSIA,1,HEATHROW,ADLER / SOCHI,0,0,0,1112,0,1112,-100
20/03/2023 10:46,2022,4,EASTERN EUROPE -OTHER,RUSSIA,1,HEATHROW,MOSCOW (DOMODEDOVO),8910,8910,0,33928,33928,0,-73.73851
20/03/2023 10:46,2022,4,EASTERN EUROPE -OTHER,RUSSIA,1,HEATHROW,MOSCOW (SHEREMETYEVO),20100,20100,0,89999,81440,8559,-77.66642
20/03/2023 10:46,2022,4,EASTERN EUROPE -OTHER,RUSSIA,2,BIGGIN HILL,KALININGRAD,0,0,0,3,0,3,-100
20/03/2023 10:46,2022,4,EASTERN EUROPE -OTHER,RUSSIA,2,BIGGIN HILL,MOSCOW (VNUKOVO),1,0,1,63,0,63,-98.4127
20/03/2023 10:46,2022,4,EASTERN EUROPE -OTHER,RUSSIA,2,BIGGIN HILL,ST PETERSBURG,0,0,0,6,0,6,-100
20/03/2023 10:46,2022,4,EASTERN EUROPE -OTHER,RUSSIA,2,BIRMINGHAM,ADLER / SOCHI,0,0,0,292,0,292,-100
20/03/2023 10:46,2022,4,EASTERN EUROPE -OTHER,RUSSIA,2,CARDIFF WALES,BRYANSK INTERNATIONAL,0,0,0,24,0,24,-100
20/03/2023 10:46,2022,4,EASTERN EUROPE -OTHER,RUSSIA,2,CARDIFF WALES,KALININGRAD,0,0,0,88,0,88,-100
20/03/2023 10:46,2022,4,EASTERN EUROPE -OTHER,RUSSIA,2,CARDIFF WALES,KAZAN,0,0,0,50,0,50,-100
20/03/2023 10:46,2022,4,EASTERN EUROPE -OTHER,RUSSIA,2,EAST MIDLANDS INTERNATIONAL,MOSCOW (SHEREMETYEVO),0,0,0,122,0,122,-100
20/03/2023 10:46,2022,4,EASTERN EUROPE -OTHER,RUSSIA,2,GLASGOW,BRYANSK INTERNATIONAL,0,0,0,64,0,64,-100
20/03/2023 10:46,2022,4,EASTERN EUROPE -OTHER,RUSSIA,2,MANCHESTER,MOSCOW (VNUKOVO),0,0,0,1,1,0,-100
20/03/2023 10:46,2022,4,EASTERN EUROPE -OTHER,UKRAINE,1,GATWICK,KIEV (BORISPOL),7468,7468,0,51526,51526,0,-85.50635
20/03/2023 10:46,2022,4,EASTERN EUROPE -OTHER,UKRAINE,1,HEATHROW,KIEV (BORISPOL),0,0,0,14544,14544,0,-100
20/03/2023 10:46,2022,4,EASTERN EUROPE -OTHER,UKRAINE,1,LUTON,KIEV (ZHULYANY),6200,6200,0,41480,41480,0,-85.05304
20/03/2023 10:46,2022,4,EASTERN EUROPE -OTHER,UKRAINE,1,LUTON,LVOV,6410,6410,0,34256,34256,0,-81.28795
20/03/2023 10:46,2022,4,EASTERN EUROPE -OTHER,UKRAINE,1,STANSTED,KIEV (BORISPOL),9652,9652,0,36602,36602,0,-73.62986
20/03/2023 10:46,2022,4,EASTERN EUROPE -OTHER,UKRAINE,1,STANSTED,LVOV,5080,5080,0,22594,22594,0,-77.51615
20/03/2023 10:46,2022,4,EASTERN EUROPE -OTHER,UKRAINE,2,BELFAST INTERNATIONAL,DNEPROPETROVSK,0,0,0,44,0,44,-100
20/03/2023 10:46,2022,4,EASTERN EUROPE -OTHER,UKRAINE,2,BELFAST INTERNATIONAL,KIEV (BORISPOL),0,0,0,79,0,79,-100
20/03/2023 10:46,2022,4,EASTERN EUROPE -OTHER,UKRAINE,2,BELFAST INTERNATIONAL,KIEV (ZHULYANY),0,0,0,78,0,78,-100
20/03/2023 10:46,2022,4,EASTERN EUROPE -OTHER,UKRAINE,2,BIGGIN HILL,KIEV (ZHULYANY),3,0,3,1,0,1,200
20/03/2023 10:46,2022,4,EASTERN EUROPE -OTHER,UKRAINE,2,EDINBURGH,KIEV (BORISPOL),0,0,0,186,0,186,-100
20/03/2023 10:46,2022,4,EASTERN EUROPE -OTHER,UKRAINE,2,GLASGOW,KIEV (BORISPOL),0,0,0,39,0,39,-100
20/03/2023 10:46,2022,4,EASTERN EUROPE -OTHER,UKRAINE,2,MANCHESTER,KIEV (BORISPOL),2770,2770,0,3319,3319,0,-16.54113
20/03/2023 10:46,2022,4,EASTERN EUROPE -OTHER,UKRAINE,2,MANCHESTER,LVOV,977,977,0,1629,1629,0,-40.02455
20/03/2023 10:46,2022,4,EASTERN EUROPE -OTHER,UKRAINE,2,TEESSIDE INTERNATIONAL AIRPORT,MYKOLAIV,0,0,0,61,0,61,-100
20/03/2023 10:46,2022,4,EASTERN EUROPE -OTHER,UZBEKISTAN,1,HEATHROW,TASHKENT,28357,28357,0,4962,4953,9,471.48327
20/03/2023 10:46,2022,25,NEAR EAST,ISRAEL,1,GATWICK,TEL AVIV,115293,115293,0,1472,1472,0,7732.40489
20/03/2023 10:46,2022,25,NEAR EAST,ISRAEL,1,HEATHROW,TEL AVIV,582029,582029,0,212030,211593,437,174.50314
20/03/2023 10:46,2022,25,NEAR EAST,ISRAEL,1,LUTON,RAMON,134,0,134,0,0,0,0
20/03/2023 10:46,2022,25,NEAR EAST,ISRAEL,1,LUTON,TEL AVIV,360729,360729,0,46539,46539,0,675.1112
20/03/2023 10:46,2022,25,NEAR EAST,ISRAEL,1,STANSTED,TEL AVIV,941,180,761,0,0,0,0
20/03/2023 10:46,2022,25,NEAR EAST,ISRAEL,2,BIGGIN HILL,TEL AVIV,11,0,11,0,0,0,0
20/03/2023 10:46,2022,25,NEAR EAST,ISRAEL,2,BIRMINGHAM,TEL AVIV,186,0,186,0,0,0,0
20/03/2023 10:46,2022,25,NEAR EAST,ISRAEL,2,DONCASTER SHEFFIELD,TEL AVIV,209,206,3,0,0,0,0
20/03/2023 10:46,2022,25,NEAR EAST,ISRAEL,2,EDINBURGH,TEL AVIV,895,0,895,0,0,0,0
20/03/2023 10:46,2022,25,NEAR EAST,ISRAEL,2,GLASGOW,TEL AVIV,0,0,0,98,0,98,-100
20/03/2023 10:46,2022,25,NEAR EAST,ISRAEL,2,MANCHESTER,TEL AVIV,48693,48693,0,11502,11429,73,323.34377
20/03/2023 10:46,2022,25,NEAR EAST,ISRAEL,2,PRESTWICK,TEL AVIV,2,0,2,0,0,0,0
20/03/2023 10:46,2022,25,NEAR EAST,JORDAN,1,GATWICK,AQABA,8551,8551,0,1822,1822,0,369.31943
20/03/2023 10:46,2022,25,NEAR EAST,JORDAN,1,HEATHROW,AMMAN,226923,226923,0,109350,109350,0,107.51989
20/03/2023 10:46,2022,25,NEAR EAST,JORDAN,1,LUTON,AMMAN,2995,2995,0,0,0,0,0
20/03/2023 10:46,2022,25,NEAR EAST,JORDAN,1,STANSTED,AQABA,53,0,53,0,0,0,0
20/03/2023 10:46,2022,25,NEAR EAST,JORDAN,2,MANCHESTER,AQABA,1996,1996,0,492,492,0,305.69106
20/03/2023 10:46,2022,25,NEAR EAST,LEBANON,1,HEATHROW,BEIRUT,149728,149728,0,83181,83181,0,80.00264
20/03/2023 10:46,2022,25,NEAR EAST,LEBANON,1,STANSTED,BEIRUT,229,0,229,0,0,0,0
20/03/2023 10:46,2022,25,NEAR EAST,LEBANON,2,BIGGIN HILL,BEIRUT,0,0,0,1,0,1,-100
20/03/2023 10:46,2022,30,NORTH AFRICA,ALGERIA,1,GATWICK,HASSI MESSAOUD,208,0,208,0,0,0,0
20/03/2023 10:46,2022,30,NORTH AFRICA,ALGERIA,1,HEATHROW,ADRAR,0,0,0,22,0,22,-100
20/03/2023 10:46,2022,30,NORTH AFRICA,ALGERIA,1,HEATHROW,ALGIERS,87584,87584,0,11157,11157,0,685.01389
20/03/2023 10:46,2022,30,NORTH AFRICA,ALGERIA,1,STANSTED,ALGIERS,8811,1062,7749,0,0,0,0
20/03/2023 10:46,2022,30,NORTH AFRICA,ALGERIA,1,STANSTED,HASSI MESSAOUD,0,0,0,36,0,36,-100
20/03/2023 10:46,2022,30,NORTH AFRICA,EGYPT,1,GATWICK,ALEXANDRIA (BORG EL ARAB),0,0,0,426,0,426,-100
20/03/2023 10:46,2022,30,NORTH AFRICA,EGYPT,1,GATWICK,CAIRO,0,0,0,317,0,317,-100
20/03/2023 10:46,2022,30,NORTH AFRICA,EGYPT,1,GATWICK,HURGHADA,130152,130152,0,25180,25180,0,416.88642
20/03/2023 10:46,2022,30,NORTH AFRICA,EGYPT,1,GATWICK,SHARM EL SHEIKH (OPHIRA),117132,117132,0,17880,17880,0,555.10067
20/03/2023 10:46,2022,30,NORTH AFRICA,EGYPT,1,HEATHROW,CAIRO,512471,512471,0,154155,154047,108,232.43878
20/03/2023 10:46,2022,30,NORTH AFRICA,EGYPT,1,HEATHROW,LUXOR,6963,6963,0,827,827,0,741.95889
20/03/2023 10:46,2022,30,NORTH AFRICA,EGYPT,1,HEATHROW,SHARM EL SHEIKH (OPHIRA),262,262,0,0,0,0,0
20/03/2023 10:46,2022,30,NORTH AFRICA,EGYPT,1,LUTON,HURGHADA,24000,24000,0,3820,3820,0,528.27225
20/03/2023 10:46,2022,30,NORTH AFRICA,EGYPT,1,LUTON,SHARM EL SHEIKH (OPHIRA),42336,42336,0,2088,2088,0,1927.58621
20/03/2023 10:46,2022,30,NORTH AFRICA,EGYPT,1,STANSTED,SHARM EL SHEIKH (OPHIRA),16278,16107,171,378,378,0,4206.34921
20/03/2023 10:46,2022,30,NORTH AFRICA,EGYPT,2,BIGGIN HILL,CAIRO,64,0,64,5,0,5,1180
20/03/2023 10:46,2022,30,NORTH AFRICA,EGYPT,2,BIRMINGHAM,HURGHADA,50723,50538,185,7161,7161,0,608.32286
20/03/2023 10:46,2022,30,NORTH AFRICA,EGYPT,2,BIRMINGHAM,SHARM EL SHEIKH (OPHIRA),43516,43307,209,4354,4354,0,899.44878
20/03/2023 10:46,2022,30,NORTH AFRICA,EGYPT,2,BRISTOL,HURGHADA,49838,49838,0,7477,7477,0,566.55076
20/03/2023 10:46,2022,30,NORTH AFRICA,EGYPT,2,BRISTOL,SHARM EL SHEIKH (OPHIRA),39914,39914,0,2667,2667,0,1396.58793
20/03/2023 10:46,2022,30,NORTH AFRICA,EGYPT,2,DONCASTER SHEFFIELD,HURGHADA,26885,18743,8142,652,652,0,4023.46626
20/03/2023 10:46,2022,30,NORTH AFRICA,EGYPT,2,EAST MIDLANDS INTERNATIONAL,SHARM EL SHEIKH (OPHIRA),6903,4210,2693,0,0,0,0
20/03/2023 10:46,2022,30,NORTH AFRICA,EGYPT,2,GLASGOW,HURGHADA,0,0,0,160,0,160,-100
20/03/2023 10:46,2022,30,NORTH AFRICA,EGYPT,2,GLASGOW,SHARM EL SHEIKH (OPHIRA),2792,2792,0,0,0,0,0
20/03/2023 10:46,2022,30,NORTH AFRICA,EGYPT,2,MANCHESTER,HURGHADA,93845,93659,186,13376,13376,0,601.5924
20/03/2023 10:46,2022,30,NORTH AFRICA,EGYPT,2,MANCHESTER,SHARM EL SHEIKH (OPHIRA),87344,87157,187,12767,12767,0,584.1388
20/03/2023 10:46,2022,30,NORTH AFRICA,EGYPT,2,NEWCASTLE,HURGHADA,16741,16741,0,2794,2794,0,499.17681
20/03/2023 10:46,2022,30,NORTH AFRICA,MOROCCO,1,GATWICK,AGADIR (AL MASSIRA),92928,92928,0,8991,8991,0,933.5669
20/03/2023 10:46,2022,30,NORTH AFRICA,MOROCCO,1,GATWICK,CASABLANCA MOHAMED V,61988,61988,0,17236,17236,0,259.64261
20/03/2023 10:46,2022,30,NORTH AFRICA,MOROCCO,1,GATWICK,ERRACHIDIA,276,0,276,215,0,215,28.37209
20/03/2023 10:46,2022,30,NORTH AFRICA,MOROCCO,1,GATWICK,MARRAKESH,293459,293040,419,18234,18232,2,1509.40551
20/03/2023 10:46,2022,30,NORTH AFRICA,MOROCCO,1,GATWICK,OUARZAZATE,300,0,300,161,0,161,86.3354
20/03/2023 10:46,2022,30,NORTH AFRICA,MOROCCO,1,GATWICK,TANGIERS (IBN BATUTA),28902,28902,0,9797,9797,0,195.00868
20/03/2023 10:46,2022,30,NORTH AFRICA,MOROCCO,1,HEATHROW,CASABLANCA MOHAMED V,92185,92185,0,25890,25890,0,256.06412
20/03/2023 10:46,2022,30,NORTH AFRICA,MOROCCO,1,HEATHROW,FEZ,0,0,0,291,0,291,-100
20/03/2023 10:46,2022,30,NORTH AFRICA,MOROCCO,1,HEATHROW,MARRAKESH,44422,44283,139,0,0,0,0
20/03/2023 10:46,2022,30,NORTH AFRICA,MOROCCO,1,HEATHROW,RABAT,3771,3771,0,3466,3466,0,8.79977
20/03/2023 10:46,2022,30,NORTH AFRICA,MOROCCO,1,LUTON,AGADIR (AL MASSIRA),22363,22363,0,0,0,0,0
20/03/2023 10:46,2022,30,NORTH AFRICA,MOROCCO,1,LUTON,MARRAKESH,25623,25623,0,510,510,0,4924.11765
20/03/2023 10:46,2022,30,NORTH AFRICA,MOROCCO,1,STANSTED,AGADIR (AL MASSIRA),57389,57291,98,8456,8456,0,578.67786
20/03/2023 10:46,2022,30,NORTH AFRICA,MOROCCO,1,STANSTED,ERRACHIDIA,0,0,0,94,0,94,-100
20/03/2023 10:46,2022,30,NORTH AFRICA,MOROCCO,1,STANSTED,ESSAOUIRA,4375,4375,0,0,0,0,0
20/03/2023 10:46,2022,30,NORTH AFRICA,MOROCCO,1,STANSTED,FEZ,26856,26856,0,0,0,0,0
20/03/2023 10:46,2022,30,NORTH AFRICA,MOROCCO,1,STANSTED,MARRAKESH,157678,157142,536,28875,28875,0,446.071
20/03/2023 10:46,2022,30,NORTH AFRICA,MOROCCO,1,STANSTED,RABAT,42687,42687,0,14888,14888,0,186.72085
20/03/2023 10:46,2022,30,NORTH AFRICA,MOROCCO,1,STANSTED,TANGIERS (IBN BATUTA),25213,25213,0,0,0,0,0
20/03/2023 10:46,2022,30,NORTH AFRICA,MOROCCO,2,BIGGIN HILL,AGADIR (AL MASSIRA),1,0,1,0,0,0,0
20/03/2023 10:46,2022,30,NORTH AFRICA,MOROCCO,2,BIGGIN HILL,CASABLANCA MOHAMED V,5,0,5,0,0,0,0
20/03/2023 10:46,2022,30,NORTH AFRICA,MOROCCO,2,BIGGIN HILL,FEZ,8,0,8,0,0,0,0
20/03/2023 10:46,2022,30,NORTH AFRICA,MOROCCO,2,BIGGIN HILL,MARRAKESH,8,0,8,0,0,0,0
20/03/2023 10:46,2022,30,NORTH AFRICA,MOROCCO,2,BIGGIN HILL,RABAT,2,0,2,0,0,0,0
20/03/2023 10:46,2022,30,NORTH AFRICA,MOROCCO,2,BIRMINGHAM,AGADIR (AL MASSIRA),10591,10591,0,0,0,0,0
20/03/2023 10:46,2022,30,NORTH AFRICA,MOROCCO,2,BIRMINGHAM,MARRAKESH,12760,12760,0,314,314,0,3963.69427
20/03/2023 10:46,2022,30,NORTH AFRICA,MOROCCO,2,BRISTOL,MARRAKESH,10235,10235,0,0,0,0,0
20/03/2023 10:46,2022,30,NORTH AFRICA,MOROCCO,2,EDINBURGH,MARRAKESH,28022,28022,0,0,0,0,0
20/03/2023 10:46,2022,30,NORTH AFRICA,MOROCCO,2,GLASGOW,AGADIR (AL MASSIRA),4257,4257,0,0,0,0,0
20/03/2023 10:46,2022,30,NORTH AFRICA,MOROCCO,2,GLASGOW,MARRAKESH,134,134,0,0,0,0,0
20/03/2023 10:46,2022,30,NORTH AFRICA,MOROCCO,2,MANCHESTER,AGADIR (AL MASSIRA),82505,82505,0,7383,7383,0,1017.49966
20/03/2023 10:46,2022,30,NORTH AFRICA,MOROCCO,2,MANCHESTER,MARRAKESH,129658,129658,0,14759,14759,0,778.50125
20/03/2023 10:46,2022,30,NORTH AFRICA,MOROCCO,2,TEESSIDE INTERNATIONAL AIRPORT,AGADIR (AL MASSIRA),0,0,0,52,0,52,-100
20/03/2023 10:46,2022,30,NORTH AFRICA,TUNISIA,1,GATWICK,ENFIDHA - HAMMAMET INTL,67812,42190,25622,1254,0,1254,5307.6555
20/03/2023 10:46,2022,30,NORTH AFRICA,TUNISIA,1,GATWICK,TUNIS,28335,28335,0,3870,3870,0,632.17054
20/03/2023 10:46,2022,30,NORTH AFRICA,TUNISIA,1,HEATHROW,TUNIS,16444,16444,0,5911,5911,0,178.1932
20/03/2023 10:46,2022,30,NORTH AFRICA,TUNISIA,1,LUTON,ENFIDHA - HAMMAMET INTL,9215,0,9215,0,0,0,0
20/03/2023 10:46,2022,30,NORTH AFRICA,TUNISIA,1,LUTON,TUNIS,169,169,0,0,0,0,0
20/03/2023 10:46,2022,30,NORTH AFRICA,TUNISIA,1,STANSTED,TUNIS,15145,15145,0,0,0,0,0
20/03/2023 10:46,2022,30,NORTH AFRICA,TUNISIA,2,BIRMINGHAM,ENFIDHA - HAMMAMET INTL,22478,0,22478,619,0,619,3531.34087
20/03/2023 10:46,2022,30,NORTH AFRICA,TUNISIA,2,CARDIFF WALES,ENFIDHA - HAMMAMET INTL,8862,0,8862,0,0,0,0
20/03/2023 10:46,2022,30,NORTH AFRICA,TUNISIA,2,DONCASTER SHEFFIELD,ENFIDHA - HAMMAMET INTL,9427,0,9427,0,0,0,0
20/03/2023 10:46,2022,30,NORTH AFRICA,TUNISIA,2,EAST MIDLANDS INTERNATIONAL,ENFIDHA - HAMMAMET INTL,9519,0,9519,0,0,0,0
20/03/2023 10:46,2022,30,NORTH AFRICA,TUNISIA,2,MANCHESTER,ENFIDHA - HAMMAMET INTL,51500,25312,26188,2174,0,2174,2268.90524
20/03/2023 10:46,2022,30,NORTH AFRICA,TUNISIA,2,NEWCASTLE,ENFIDHA - HAMMAMET INTL,18302,18302,0,0,0,0,0
20/03/2023 10:46,2022,35,EAST AFRICA,ETHIOPIA,1,HEATHROW,ADDIS ABABA,219282,219281,1,97671,97671,0,124.51086
20/03/2023 10:46,2022,35,EAST AFRICA,ETHIOPIA,2,MANCHESTER,ADDIS ABABA,47030,47030,0,13099,13099,0,259.03504
20/03/2023 10:46,2022,35,EAST AFRICA,KENYA,1,HEATHROW,ELDORET INTERNATIONAL AIRPORT,0,0,0,39,0,39,-100
20/03/2023 10:46,2022,35,EAST AFRICA,KENYA,1,HEATHROW,NAIROBI,298598,298598,0,71814,71813,1,315.79358
20/03/2023 10:46,2022,35,EAST AFRICA,KENYA,2,BIRMINGHAM,NAIROBI,0,0,0,775,0,775,-100
20/03/2023 10:46,2022,35,EAST AFRICA,KENYA,2,EAST MIDLANDS INTERNATIONAL,NAIROBI,0,0,0,138,0,138,-100
20/03/2023 10:46,2022,35,EAST AFRICA,RWANDA,1,HEATHROW,KIGALI,35874,35874,0,3289,3289,0,990.72666
20/03/2023 10:46,2022,40,WEST AFRICA,GAMBIA,1,GATWICK,BANJUL,31623,865,30758,6751,0,6751,368.41949
20/03/2023 10:46,2022,40,WEST AFRICA,GAMBIA,1,HEATHROW,BANJUL,173,173,0,0,0,0,0
20/03/2023 10:46,2022,40,WEST AFRICA,GAMBIA,2,MANCHESTER,BANJUL,15738,0,15738,2913,0,2913,440.26777
20/03/2023 10:46,2022,40,WEST AFRICA,GHANA,1,GATWICK,ACCRA,0,0,0,48,0,48,-100
20/03/2023 10:46,2022,40,WEST AFRICA,GHANA,1,HEATHROW,ACCRA,184062,184062,0,169966,169966,0,8.29342
20/03/2023 10:46,2022,40,WEST AFRICA,IVORY COAST,2,ABERDEEN,ABIDJAN,0,0,0,38,0,38,-100
20/03/2023 10:46,2022,40,WEST AFRICA,NIGERIA,1,GATWICK,LAGOS,35,0,35,0,0,0,0
20/03/2023 10:46,2022,40,WEST AFRICA,NIGERIA,1,HEATHROW,ABUJA,124768,124768,0,105799,105799,0,17.92928
20/03/2023 10:46,2022,40,WEST AFRICA,NIGERIA,1,HEATHROW,LAGOS,327235,327235,0,290593,290574,19,12.60939
20/03/2023 10:46,2022,40,WEST AFRICA,SENEGAL,1,GATWICK,DAKAR,187,0,187,0,0,0,0
20/03/2023 10:46,2022,40,WEST AFRICA,SENEGAL,1,GATWICK,DAKAR (BLAISE DIAGNE),2461,0,2461,0,0,0,0
20/03/2023 10:46,2022,40,WEST AFRICA,SENEGAL,2,BIRMINGHAM,DAKAR (BLAISE DIAGNE),0,0,0,59,0,59,-100
20/03/2023 10:46,2022,50,SOUTHERN AFRICA,REPUBLIC OF SOUTH AFRICA,1,GATWICK,CAPE TOWN,3547,3547,0,0,0,0,0
20/03/2023 10:46,2022,50,SOUTHERN AFRICA,REPUBLIC OF SOUTH AFRICA,1,HEATHROW,CAPE TOWN,268191,267713,478,18349,18349,0,1361.61099
20/03/2023 10:46,2022,50,SOUTHERN AFRICA,REPUBLIC OF SOUTH AFRICA,1,HEATHROW,JOHANNESBURG,547227,547227,0,59123,58905,218,825.5738
20/03/2023 10:46,2022,50,SOUTHERN AFRICA,REPUBLIC OF SOUTH AFRICA,2,EDINBURGH,JOHANNESBURG,0,0,0,80,0,80,-100
20/03/2023 10:46,2022,50,SOUTHERN AFRICA,REPUBLIC OF SOUTH AFRICA,2,MANCHESTER,CAPE TOWN,450,0,450,0,0,0,0
20/03/2023 10:46,2022,50,SOUTHERN AFRICA,ZIMBABWE,1,GATWICK,HARARE,250,0,250,126,0,126,98.4127
20/03/2023 10:46,2022,55,MIDDLE EAST,BAHRAIN,1,HEATHROW,BAHRAIN,426063,425686,377,176560,174752,1808,141.31343
20/03/2023 10:46,2022,55,MIDDLE EAST,BAHRAIN,2,MANCHESTER,BAHRAIN,32140,32140,0,0,0,0,0
20/03/2023 10:46,2022,55,MIDDLE EAST,IRAN,1,HEATHROW,TEHRAN IMAM KHOMEINI,50668,50668,0,38313,38313,0,32.24754
20/03/2023 10:46,2022,55,MIDDLE EAST,IRAQ,1,GATWICK,BAGHDAD (GECA),44,44,0,1478,1478,0,-97.023
20/03/2023 10:46,2022,55,MIDDLE EAST,IRAQ,1,GATWICK,ERBIL INTERNATIONAL,0,0,0,1,0,1,-100
20/03/2023 10:46,2022,55,MIDDLE EAST,IRAQ,1,GATWICK,SULAYMANIYAH INT,283,283,0,1812,1812,0,-84.3819
20/03/2023 10:46,2022,55,MIDDLE EAST,KUWAIT,1,GATWICK,KUWAIT,0,0,0,256,0,256,-100
20/03/2023 10:46,2022,55,MIDDLE EAST,KUWAIT,1,HEATHROW,KUWAIT,335074,335074,0,87834,87762,72,281.48553
20/03/2023 10:46,2022,55,MIDDLE EAST,KUWAIT,2,ABERDEEN,KUWAIT,110,0,110,0,0,0,0
20/03/2023 10:46,2022,55,MIDDLE EAST,KUWAIT,2,BIGGIN HILL,KUWAIT,0,0,0,11,0,11,-100
20/03/2023 10:46,2022,55,MIDDLE EAST,KUWAIT,2,EDINBURGH,KUWAIT,0,0,0,174,0,174,-100
20/03/2023 10:46,2022,55,MIDDLE EAST,KUWAIT,2,MANCHESTER,KUWAIT,24271,24271,0,0,0,0,0
20/03/2023 10:46,2022,55,MIDDLE EAST,OMAN,1,HEATHROW,MUSCAT,134081,134081,0,25250,24633,617,431.01386
20/03/2023 10:46,2022,55,MIDDLE EAST,OMAN,1,STANSTED,MUSCAT,55,0,55,0,0,0,0
20/03/2023 10:46,2022,55,MIDDLE EAST,OMAN,2,BIRMINGHAM,MUSCAT,226,0,226,0,0,0,0
20/03/2023 10:46,2022,55,MIDDLE EAST,OMAN,2,EAST MIDLANDS INTERNATIONAL,MUSCAT,0,0,0,132,0,132,-100
20/03/2023 10:46,2022,55,MIDDLE EAST,QATAR,1,GATWICK,DOHA HAMAD,194709,194197,512,7352,7349,3,2548.38139
20/03/2023 10:46,2022,55,MIDDLE EAST,QATAR,1,HEATHROW,DOHA HAMAD,1491364,1490887,477,394835,394155,680,277.71829
20/03/2023 10:46,2022,55,MIDDLE EAST,QATAR,2,BELFAST INTERNATIONAL,DOHA INTERNATIONAL,0,0,0,915,0,915,-100
20/03/2023 10:46,2022,55,MIDDLE EAST,QATAR,2,BIRMINGHAM,DOHA HAMAD,829,751,78,0,0,0,0
20/03/2023 10:46,2022,55,MIDDLE EAST,QATAR,2,CARDIFF WALES,DOHA HAMAD,1894,0,1894,0,0,0,0
20/03/2023 10:46,2022,55,MIDDLE EAST,QATAR,2,CARDIFF WALES,DOHA INTERNATIONAL,745,0,745,0,0,0,0
20/03/2023 10:46,2022,55,MIDDLE EAST,QATAR,2,EDINBURGH,DOHA HAMAD,144895,144895,0,26851,26851,0,439.62608
20/03/2023 10:46,2022,55,MIDDLE EAST,QATAR,2,MANCHESTER,DOHA HAMAD,573229,573229,0,158099,158099,0,262.57598
20/03/2023 10:46,2022,55,MIDDLE EAST,SAUDI ARABIA,1,GATWICK,RIYADH,199,0,199,0,0,0,0
20/03/2023 10:46,2022,55,MIDDLE EAST,SAUDI ARABIA,1,HEATHROW,JEDDAH,205316,204944,372,63799,63074,725,221.81696
20/03/2023 10:46,2022,55,MIDDLE EAST,SAUDI ARABIA,1,HEATHROW,NEOM BAY,246,246,0,0,0,0,0
20/03/2023 10:46,2022,55,MIDDLE EAST,SAUDI ARABIA,1,HEATHROW,RIYADH,376343,375943,400,121244,121156,88,210.40134
20/03/2023 10:46,2022,55,MIDDLE EAST,SAUDI ARABIA,2,BIGGIN HILL,JEDDAH,2,0,2,0,0,0,0
20/03/2023 10:46,2022,55,MIDDLE EAST,SAUDI ARABIA,2,BIRMINGHAM,RIYADH,106,0,106,0,0,0,0
20/03/2023 10:46,2022,55,MIDDLE EAST,SAUDI ARABIA,2,EDINBURGH,RIYADH,0,0,0,186,0,186,-100
20/03/2023 10:46,2022,55,MIDDLE EAST,SAUDI ARABIA,2,GLASGOW,RIYADH,0,0,0,168,168,0,-100
20/03/2023 10:46,2022,55,MIDDLE EAST,SAUDI ARABIA,2,LIVERPOOL (JOHN LENNON),TABUK,133,0,133,0,0,0,0
20/03/2023 10:46,2022,55,MIDDLE EAST,SAUDI ARABIA,2,MANCHESTER,JEDDAH,78931,78931,0,2409,2409,0,3176.50477
20/03/2023 10:46,2022,55,MIDDLE EAST,SAUDI ARABIA,2,NEWCASTLE,JEDDAH,58,0,58,0,0,0,0
20/03/2023 10:46,2022,55,MIDDLE EAST,SAUDI ARABIA,2,NEWCASTLE,RIYADH,200,0,200,0,0,0,0
20/03/2023 10:46,2022,55,MIDDLE EAST,UNITED ARAB EMIRATES,1,GATWICK,DUBAI,658158,658158,0,15090,15090,0,4261.5507
20/03/2023 10:46,2022,55,MIDDLE EAST,UNITED ARAB EMIRATES,1,GATWICK,DUBAI (WORLD CENTRAL),2,0,2,8,0,8,-75
20/03/2023 10:46,2022,55,MIDDLE EAST,UNITED ARAB EMIRATES,1,GATWICK,SHARJAH,3,0,3,0,0,0,0
20/03/2023 10:46,2022,55,MIDDLE EAST,UNITED ARAB EMIRATES,1,HEATHROW,ABU DHABI INTERNATIONAL,711343,711343,0,175874,175761,113,304.46172
20/03/2023 10:46,2022,55,MIDDLE EAST,UNITED ARAB EMIRATES,1,HEATHROW,DUBAI,2260330,2260330,0,808620,808620,0,179.52932
20/03/2023 10:46,2022,55,MIDDLE EAST,UNITED ARAB EMIRATES,1,HEATHROW,DUBAI (WORLD CENTRAL),0,0,0,3589,0,3589,-100
20/03/2023 10:46,2022,55,MIDDLE EAST,UNITED ARAB EMIRATES,1,STANSTED,DUBAI,95802,95802,0,0,0,0,0
20/03/2023 10:46,2022,55,MIDDLE EAST,UNITED ARAB EMIRATES,2,BIGGIN HILL,DUBAI (WORLD CENTRAL),28,0,28,11,0,11,154.54545
20/03/2023 10:46,2022,55,MIDDLE EAST,UNITED ARAB EMIRATES,2,BIRMINGHAM,DUBAI,481136,481136,0,108611,107459,1152,342.99012
20/03/2023 10:46,2022,55,MIDDLE EAST,UNITED ARAB EMIRATES,2,BIRMINGHAM,DUBAI (WORLD CENTRAL),0,0,0,6568,0,6568,-100
20/03/2023 10:46,2022,55,MIDDLE EAST,UNITED ARAB EMIRATES,2,DONCASTER SHEFFIELD,DUBAI,24,0,24,0,0,0,0
20/03/2023 10:46,2022,55,MIDDLE EAST,UNITED ARAB EMIRATES,2,EAST MIDLANDS INTERNATIONAL,RAS AL KHAIMAH,101,0,101,0,0,0,0
20/03/2023 10:46,2022,55,MIDDLE EAST,UNITED ARAB EMIRATES,2,GLASGOW,DUBAI,243992,243992,0,67469,67415,54,261.63571
20/03/2023 10:46,2022,55,MIDDLE EAST,UNITED ARAB EMIRATES,2,GLASGOW,DUBAI (WORLD CENTRAL),105,0,105,53,0,53,98.11321
20/03/2023 10:46,2022,55,MIDDLE EAST,UNITED ARAB EMIRATES,2,MANCHESTER,ABU DHABI INTERNATIONAL,213660,213660,0,60248,60248,0,254.63418
20/03/2023 10:46,2022,55,MIDDLE EAST,UNITED ARAB EMIRATES,2,MANCHESTER,DUBAI,765235,765235,0,207497,207497,0,268.79328
20/03/2023 10:46,2022,55,MIDDLE EAST,UNITED ARAB EMIRATES,2,MANCHESTER,DUBAI (WORLD CENTRAL),0,0,0,903,113,790,-100
20/03/2023 10:46,2022,55,MIDDLE EAST,UNITED ARAB EMIRATES,2,NEWCASTLE,DUBAI,144456,144406,50,17657,17657,0,718.12312
20/03/2023 10:46,2022,55,MIDDLE EAST,UNITED ARAB EMIRATES,2,NEWCASTLE,DUBAI (WORLD CENTRAL),50,0,50,0,0,0,0
20/03/2023 10:46,2022,55,MIDDLE EAST,UNITED ARAB EMIRATES,2,PRESTWICK,DUBAI,123,0,123,0,0,0,0
20/03/2023 10:46,2022,60,INDIAN SUB-CONTINENT,AFGHANISTAN,1,STANSTED,KABUL,0,0,0,74,0,74,-100
20/03/2023 10:46,2022,60,INDIAN SUB-CONTINENT,AFGHANISTAN,2,BIRMINGHAM,KABUL,0,0,0,545,0,545,-100
20/03/2023 10:46,2022,60,INDIAN SUB-CONTINENT,BANGLADESH,1,HEATHROW,DHAKHA,85493,85493,0,17897,17897,0,377.69459
20/03/2023 10:46,2022,60,INDIAN SUB-CONTINENT,BANGLADESH,1,HEATHROW,SYLHET,74981,74981,0,25200,25200,0,197.54365
20/03/2023 10:46,2022,60,INDIAN SUB-CONTINENT,BANGLADESH,2,MANCHESTER,DHAKHA,50958,50958,0,773,773,0,6492.23803
20/03/2023 10:46,2022,60,INDIAN SUB-CONTINENT,INDIA,1,GATWICK,GOA,3497,0,3497,0,0,0,0
20/03/2023 10:46,2022,60,INDIAN SUB-CONTINENT,INDIA,1,GATWICK,MUMBAI,14,14,0,0,0,0,0
20/03/2023 10:46,2022,60,INDIAN SUB-CONTINENT,INDIA,1,HEATHROW,AHMEDABAD,70557,70557,0,17129,17084,45,311.91547
20/03/2023 10:46,2022,60,INDIAN SUB-CONTINENT,INDIA,1,HEATHROW,AMRITSAR,56002,56002,0,8674,8674,0,545.63062
20/03/2023 10:46,2022,60,INDIAN SUB-CONTINENT,INDIA,1,HEATHROW,BANGALORE (BENGALURU),146085,146085,0,98558,89229,9329,48.22237
20/03/2023 10:46,2022,60,INDIAN SUB-CONTINENT,INDIA,1,HEATHROW,CHENNAI,96379,96379,0,25457,25457,0,278.59528
20/03/2023 10:46,2022,60,INDIAN SUB-CONTINENT,INDIA,1,HEATHROW,COCHIN,69767,69767,0,24378,24378,0,186.18837
20/03/2023 10:46,2022,60,INDIAN SUB-CONTINENT,INDIA,1,HEATHROW,DELHI,892836,892836,0,323844,305887,17957,175.69941
20/03/2023 10:46,2022,60,INDIAN SUB-CONTINENT,INDIA,1,HEATHROW,GOA,62809,62809,0,16350,16123,227,284.15291
20/03/2023 10:46,2022,60,INDIAN SUB-CONTINENT,INDIA,1,HEATHROW,HYDERABAD ( RAJIV GHANDI ),158602,158602,0,61728,61728,0,156.93688
20/03/2023 10:46,2022,60,INDIAN SUB-CONTINENT,INDIA,1,HEATHROW,KOLKATA,3322,3322,0,7499,7499,0,-55.70076
20/03/2023 10:46,2022,60,INDIAN SUB-CONTINENT,INDIA,1,HEATHROW,MUMBAI,596942,596942,0,226928,209708,17220,163.05348
20/03/2023 10:46,2022,60,INDIAN SUB-CONTINENT,INDIA,2,BIRMINGHAM,AMRITSAR,32340,32340,0,8146,7953,193,297.00466
20/03/2023 10:46,2022,60,INDIAN SUB-CONTINENT,INDIA,2,BIRMINGHAM,DELHI,14893,14893,0,117,0,117,12629.05983
20/03/2023 10:46,2022,60,INDIAN SUB-CONTINENT,INDIA,2,GLASGOW,MUMBAI,0,0,0,119,0,119,-100
20/03/2023 10:46,2022,60,INDIAN SUB-CONTINENT,INDIA,2,MANCHESTER,GOA,2235,0,2235,0,0,0,0
20/03/2023 10:46,2022,60,INDIAN SUB-CONTINENT,PAKISTAN,1,GATWICK,BENAZIR BHUTTO INTERNATIONAL AIRPORT,34041,34041,0,195,0,195,17356.92308
20/03/2023 10:46,2022,60,INDIAN SUB-CONTINENT,PAKISTAN,1,HEATHROW,ISLAMABAD INTERNATIONAL AIRPORT,127997,113499,14498,159665,142602,17063,-19.83403
20/03/2023 10:46,2022,60,INDIAN SUB-CONTINENT,PAKISTAN,1,HEATHROW,LAHORE,101931,101931,0,90105,89888,217,13.12469
20/03/2023 10:46,2022,60,INDIAN SUB-CONTINENT,PAKISTAN,1,STANSTED,ISLAMABAD INTERNATIONAL AIRPORT,0,0,0,479,0,479,-100
20/03/2023 10:46,2022,60,INDIAN SUB-CONTINENT,PAKISTAN,2,BIRMINGHAM,ISLAMABAD INTERNATIONAL AIRPORT,39062,0,39062,8624,0,8624,352.94527
20/03/2023 10:46,2022,60,INDIAN SUB-CONTINENT,PAKISTAN,2,BIRMINGHAM,LAHORE,0,0,0,37,0,37,-100
20/03/2023 10:46,2022,60,INDIAN SUB-CONTINENT,PAKISTAN,2,DONCASTER SHEFFIELD,ISLAMABAD INTERNATIONAL AIRPORT,8725,0,8725,0,0,0,0
20/03/2023 10:46,2022,60,INDIAN SUB-CONTINENT,PAKISTAN,2,MANCHESTER,ISLAMABAD INTERNATIONAL AIRPORT,82591,49133,33458,65515,39194,26321,26.06426
20/03/2023 10:46,2022,60,INDIAN SUB-CONTINENT,PAKISTAN,2,MANCHESTER,LAHORE,0,0,0,1530,251,1279,-100
20/03/2023 10:46,2022,60,INDIAN SUB-CONTINENT,SRI LANKA,1,HEATHROW,COLOMBO,201169,201169,0,36789,36789,0,446.81834
20/03/2023 10:46,2022,60,INDIAN SUB-CONTINENT,SRI LANKA,1,HEATHROW,MATTALA RAJAPAKSA,0,0,0,40,0,40,-100
20/03/2023 10:46,2022,60,INDIAN SUB-CONTINENT,SRI LANKA,2,BIRMINGHAM,COLOMBO,0,0,0,36,0,36,-100
20/03/2023 10:46,2022,65,FAR EAST,BRUNEI,1,HEATHROW,BANDAR SERI BEGAWAN,30963,30963,0,3418,3418,0,805.88063
20/03/2023 10:46,2022,65,FAR EAST,CHINA,1,GATWICK,BEIJING,86,0,86,0,0,0,0
20/03/2023 10:46,2022,65,FAR EAST,CHINA,1,HEATHROW,BEIJING,7152,6726,426,171,0,171,4082.45614
20/03/2023 10:46,2022,65,FAR EAST,CHINA,1,HEATHROW,GUANGZHOU BAIYUN INTERNATIONAL,6046,6046,0,0,0,0,0
20/03/2023 10:46,2022,65,FAR EAST,CHINA,1,HEATHROW,QINGDAO,4955,4907,48,0,0,0,0
20/03/2023 10:46,2022,65,FAR EAST,CHINA,1,HEATHROW,SHANGHAI (PU DONG),15322,15182,140,456,251,205,3260.08772
20/03/2023 10:46,2022,65,FAR EAST,CHINA,1,HEATHROW,SHENZHEN (HUANGTIAN),338,0,338,0,0,0,0
20/03/2023 10:46,2022,65,FAR EAST,CHINA,1,HEATHROW,TIANJIN,29,0,29,0,0,0,0
20/03/2023 10:46,2022,65,FAR EAST,CHINA,2,EDINBURGH,BEIJING,470,0,470,0,0,0,0
20/03/2023 10:46,2022,65,FAR EAST,CHINA,2,MANCHESTER,BEIJING,2873,2675,198,0,0,0,0
20/03/2023 10:46,2022,65,FAR EAST,CHINA,2,MANCHESTER,CHONGQING JIANGBEI INTERNATIONAL,0,0,0,2827,0,2827,-100
20/03/2023 10:46,2022,65,FAR EAST,CHINA,2,MANCHESTER,DALIAN ZHOUSHUIZI,114,114,0,0,0,0,0
20/03/2023 10:46,2022,65,FAR EAST,CHINA,2,MANCHESTER,NANJING LUKOU INTERNATIONAL,227,0,227,0,0,0,0
20/03/2023 10:46,2022,65,FAR EAST,CHINA,2,MANCHESTER,SHANGHAI (PU DONG),316,0,316,0,0,0,0
20/03/2023 10:46,2022,65,FAR EAST,HONG KONG,1,HEATHROW,HONG KONG (CHEK LAP KOK),239018,239018,0,191096,191096,0,25.07745
20/03/2023 10:46,2022,65,FAR EAST,HONG KONG,2,MANCHESTER,HONG KONG (CHEK LAP KOK),61780,61780,0,17498,17498,0,253.06892
20/03/2023 10:46,2022,65,FAR EAST,JAPAN,1,HEATHROW,NAGOYA,388,0,388,114,114,0,240.35088
20/03/2023 10:46,2022,65,FAR EAST,JAPAN,1,HEATHROW,OSAKA (KANSAI),0,0,0,1161,1161,0,-100
20/03/2023 10:46,2022,65,FAR EAST,JAPAN,1,HEATHROW,TOKYO (HANEDA),238729,238729,0,63795,63795,0,274.21271
20/03/2023 10:46,2022,65,FAR EAST,MALAYSIA,1,GATWICK,KUALA LUMPUR (SEPANG),7,0,7,0,0,0,0
20/03/2023 10:46,2022,65,FAR EAST,MALAYSIA,1,HEATHROW,KUALA LUMPUR (SEPANG),258372,258372,0,14914,14849,65,1632.4125
20/03/2023 10:46,2022,65,FAR EAST,PHILIPPINES,1,HEATHROW,MANILA,3505,3505,0,2549,2549,0,37.5049
20/03/2023 10:46,2022,65,FAR EAST,REPUBLIC OF KOREA,1,HEATHROW,SEOUL (INCHEON),155272,155087,185,21290,21290,0,629.31893
20/03/2023 10:46,2022,65,FAR EAST,SINGAPORE,1,GATWICK,SINGAPORE,1198,1198,0,1903,1903,0,-37.04677
20/03/2023 10:46,2022,65,FAR EAST,SINGAPORE,1,HEATHROW,SINGAPORE,949782,949725,57,187739,187674,65,405.90554
20/03/2023 10:46,2022,65,FAR EAST,SINGAPORE,2,MANCHESTER,SINGAPORE,61623,61546,77,10372,10372,0,494.12842
20/03/2023 10:46,2022,65,FAR EAST,TAIWAN,1,HEATHROW,TAIPEI,79293,79293,0,1617,1617,0,4803.71058
20/03/2023 10:46,2022,65,FAR EAST,THAILAND,1,GATWICK,BANGKOK SUVARNABHUMI ,22296,22296,0,0,0,0,0
20/03/2023 10:46,2022,65,FAR EAST,THAILAND,1,GATWICK,PHUKET,8274,0,8274,468,0,468,1667.94872
20/03/2023 10:46,2022,65,FAR EAST,THAILAND,1,HEATHROW,BANGKOK SUVARNABHUMI ,392553,392553,0,32631,18532,14099,1103.00634
20/03/2023 10:46,2022,65,FAR EAST,THAILAND,1,HEATHROW,PHUKET,0,0,0,1417,37,1380,-100
20/03/2023 10:46,2022,65,FAR EAST,THAILAND,2,MANCHESTER,BANGKOK (DON MUANG),258,0,258,0,0,0,0
20/03/2023 10:46,2022,65,FAR EAST,THAILAND,2,MANCHESTER,PHUKET,4621,0,4621,0,0,0,0
20/03/2023 10:46,2022,65,FAR EAST,VIETNAM,1,GATWICK,HANOI,4708,4578,130,0,0,0,0
20/03/2023 10:46,2022,65,FAR EAST,VIETNAM,1,GATWICK,HO CHI MINH CITY,1984,1984,0,0,0,0,0
20/03/2023 10:46,2022,65,FAR EAST,VIETNAM,1,HEATHROW,HANOI,56741,56501,240,825,654,171,6777.69697
20/03/2023 10:46,2022,65,FAR EAST,VIETNAM,1,HEATHROW,HO CHI MINH CITY,14675,14675,0,346,346,0,4141.32948
20/03/2023 10:46,2022,65,FAR EAST,VIETNAM,2,BIRMINGHAM,VAN DON INTERNATIONAL,0,0,0,299,0,299,-100
20/03/2023 10:46,2022,70,AUSTRALASIA,AUSTRALIA,1,HEATHROW,DARWIN,42609,42609,0,10580,10580,0,302.73157
20/03/2023 10:46,2022,70,AUSTRALASIA,AUSTRALIA,1,HEATHROW,MELBOURNE,82785,82785,0,3971,3971,0,1984.73936
20/03/2023 10:46,2022,70,AUSTRALASIA,AUSTRALIA,1,HEATHROW,PERTH (AUSTRALIA),85919,85919,0,179,179,0,47899.44134
20/03/2023 10:46,2022,70,AUSTRALASIA,AUSTRALIA,1,HEATHROW,SYDNEY,262169,262169,0,13557,13557,0,1833.82754
20/03/2023 10:46,2022,75,CANADA,CANADA,1,GATWICK,CALGARY,68976,68976,0,27739,27739,0,148.66073
20/03/2023 10:46,2022,75,CANADA,CANADA,1,GATWICK,HALIFAX INT,21897,21897,0,0,0,0,0
20/03/2023 10:46,2022,75,CANADA,CANADA,1,GATWICK,MONTREAL (DORVAL),59470,59396,74,0,0,0,0
20/03/2023 10:46,2022,75,CANADA,CANADA,1,GATWICK,OTTAWA INTERNATIONAL,24,24,0,0,0,0,0
20/03/2023 10:46,2022,75,CANADA,CANADA,1,GATWICK,QUEBEC,5284,5284,0,0,0,0,0
20/03/2023 10:46,2022,75,CANADA,CANADA,1,GATWICK,TORONTO,308610,308610,0,47963,47963,0,543.43348
20/03/2023 10:46,2022,75,CANADA,CANADA,1,GATWICK,VANCOUVER,77506,77506,0,0,0,0,0
20/03/2023 10:46,2022,75,CANADA,CANADA,1,HEATHROW,CALGARY,247289,247289,0,15127,15127,0,1534.75243
20/03/2023 10:46,2022,75,CANADA,CANADA,1,HEATHROW,HALIFAX INT,59770,59770,0,0,0,0,0
20/03/2023 10:46,2022,75,CANADA,CANADA,1,HEATHROW,MONTREAL (DORVAL),301427,301427,0,55477,55477,0,443.33688
20/03/2023 10:46,2022,75,CANADA,CANADA,1,HEATHROW,ST JOHNS,234,234,0,0,0,0,0
20/03/2023 10:46,2022,75,CANADA,CANADA,1,HEATHROW,TORONTO,786519,786519,0,297113,297113,0,164.72049
20/03/2023 10:46,2022,75,CANADA,CANADA,1,HEATHROW,VANCOUVER,475180,475180,0,114306,114306,0,315.70871
20/03/2023 10:46,2022,75,CANADA,CANADA,1,HEATHROW,WINNIPEG,0,0,0,218,0,218,-100
20/03/2023 10:46,2022,75,CANADA,CANADA,1,STANSTED,TORONTO,14,0,14,0,0,0,0
20/03/2023 10:46,2022,75,CANADA,CANADA,2,ABERDEEN,MONTREAL (DORVAL),26,26,0,0,0,0,0
20/03/2023 10:46,2022,75,CANADA,CANADA,2,ABERDEEN,TORONTO,19,0,19,0,0,0,0
20/03/2023 10:46,2022,75,CANADA,CANADA,2,BELFAST INTERNATIONAL,TORONTO,85,0,85,0,0,0,0
20/03/2023 10:46,2022,75,CANADA,CANADA,2,BIRMINGHAM,CALGARY,140,0,140,0,0,0,0
20/03/2023 10:46,2022,75,CANADA,CANADA,2,EAST MIDLANDS INTERNATIONAL,HALIFAX INT,100,0,100,0,0,0,0
20/03/2023 10:46,2022,75,CANADA,CANADA,2,EDINBURGH,TORONTO,69742,69742,0,0,0,0,0
20/03/2023 10:46,2022,75,CANADA,CANADA,2,GLASGOW,HALIFAX INT,17245,17245,0,0,0,0,0
20/03/2023 10:46,2022,75,CANADA,CANADA,2,GLASGOW,TORONTO,81688,81688,0,998,998,0,8085.17034
20/03/2023 10:46,2022,75,CANADA,CANADA,2,MANCHESTER,TORONTO,107930,107930,0,3609,3609,0,2890.57911
20/03/2023 10:46,2022,80,UNITED STATES OF AMERICA,USA,1,GATWICK,AUSTIN (BERGSTROM),0,0,0,72,0,72,-100
20/03/2023 10:46,2022,80,UNITED STATES OF AMERICA,USA,1,GATWICK,BOSTON,27342,27342,0,0,0,0,0
20/03/2023 10:46,2022,80,UNITED STATES OF AMERICA,USA,1,GATWICK,BUFFALO,2,0,2,0,0,0,0
20/03/2023 10:46,2022,80,UNITED STATES OF AMERICA,USA,1,GATWICK,MELBOURNE FLATS,41550,0,41550,0,0,0,0
20/03/2023 10:46,2022,80,UNITED STATES OF AMERICA,USA,1,GATWICK,MIAMI INTERNATIONAL,543,543,0,0,0,0,0
20/03/2023 10:46,2022,80,UNITED STATES OF AMERICA,USA,1,GATWICK,NEW YORK (JF KENNEDY),271409,271317,92,12649,12649,0,2045.69531
20/03/2023 10:46,2022,80,UNITED STATES OF AMERICA,USA,1,GATWICK,ORLANDO,239729,239257,472,8118,8118,0,2853.05494
20/03/2023 10:46,2022,80,UNITED STATES OF AMERICA,USA,1,GATWICK,TAMPA,152908,152908,0,16381,16381,0,833.44729
20/03/2023 10:46,2022,80,UNITED STATES OF AMERICA,USA,1,GATWICK,WILLIAM P HOBBY AIRPORT,0,0,0,449,0,449,-100
20/03/2023 10:46,2022,80,UNITED STATES OF AMERICA,USA,1,HEATHROW,ATLANTA,499431,499431,0,164335,164179,156,203.91031
20/03/2023 10:46,2022,80,UNITED STATES OF AMERICA,USA,1,HEATHROW,AUSTIN (BERGSTROM),180717,180717,0,14209,13035,1174,1171.84883
20/03/2023 10:46,2022,80,UNITED STATES OF AMERICA,USA,1,HEATHROW,BALTIMORE,79250,79250,0,5864,5864,0,1251.46658
20/03/2023 10:46,2022,80,UNITED STATES OF AMERICA,USA,1,HEATHROW,BOSTON,800673,800673,0,172975,172975,0,362.88365
20/03/2023 10:46,2022,80,UNITED STATES OF AMERICA,USA,1,HEATHROW,CHARLOTTE,286536,286395,141,78121,78121,0,266.78486
20/03/2023 10:46,2022,80,UNITED STATES OF AMERICA,USA,1,HEATHROW,CHICAGO (O'HARE),896746,896746,0,236746,236746,0,278.77979
20/03/2023 10:46,2022,80,UNITED STATES OF AMERICA,USA,1,HEATHROW,DALLAS/FORT WORTH,715621,715621,0,198773,198773,0,260.01922
20/03/2023 10:46,2022,80,UNITED STATES OF AMERICA,USA,1,HEATHROW,DENVER INTERNATIONAL,331250,330820,430,22158,22158,0,1394.94539
20/03/2023 10:46,2022,80,UNITED STATES OF AMERICA,USA,1,HEATHROW,DETROIT,137762,137762,0,13011,13011,0,958.81177
20/03/2023 10:46,2022,80,UNITED STATES OF AMERICA,USA,1,HEATHROW,GREEN BAY WISCONSIN,171,0,171,0,0,0,0
20/03/2023 10:46,2022,80,UNITED STATES OF AMERICA,USA,1,HEATHROW,HOUSTON,381967,381967,0,78022,78022,0,389.5632
20/03/2023 10:46,2022,80,UNITED STATES OF AMERICA,USA,1,HEATHROW,JACKSONVILLE,0,0,0,140,0,140,-100
20/03/2023 10:46,2022,80,UNITED STATES OF AMERICA,USA,1,HEATHROW,LAS VEGAS,350388,350388,0,26767,26767,0,1209.02978
20/03/2023 10:46,2022,80,UNITED STATES OF AMERICA,USA,1,HEATHROW,LOS ANGELES INTERNATIONAL,1225487,1225487,0,287992,287992,0,325.52814
20/03/2023 10:46,2022,80,UNITED STATES OF AMERICA,USA,1,HEATHROW,MIAMI INTERNATIONAL,821184,821184,0,201288,201288,0,307.96471
20/03/2023 10:46,2022,80,UNITED STATES OF AMERICA,USA,1,HEATHROW,MILWAUKEE,0,0,0,297,0,297,-100
20/03/2023 10:46,2022,80,UNITED STATES OF AMERICA,USA,1,HEATHROW,MINNEAPOLIS-ST PAUL,96720,96367,353,0,0,0,0
20/03/2023 10:46,2022,80,UNITED STATES OF AMERICA,USA,1,HEATHROW,NASHVILLE METROPOLITAN,78661,78661,0,2740,2740,0,2770.83942
20/03/2023 10:46,2022,80,UNITED STATES OF AMERICA,USA,1,HEATHROW,NEW ORLEANS,45425,45425,0,2206,2206,0,1959.15684
20/03/2023 10:46,2022,80,UNITED STATES OF AMERICA,USA,1,HEATHROW,NEW YORK (JF KENNEDY),2373529,2373529,0,615543,615278,265,285.59922
20/03/2023 10:46,2022,80,UNITED STATES OF AMERICA,USA,1,HEATHROW,NEW YORK (NEWARK),810084,810084,0,140398,140398,0,476.99113
20/03/2023 10:46,2022,80,UNITED STATES OF AMERICA,USA,1,HEATHROW,ORLANDO,456014,454506,1508,44763,44763,0,918.72975
20/03/2023 10:46,2022,80,UNITED STATES OF AMERICA,USA,1,HEATHROW,PHILADELPHIA INTERNATIONAL,353258,353258,0,79874,79874,0,342.26907
20/03/2023 10:46,2022,80,UNITED STATES OF AMERICA,USA,1,HEATHROW,PHOENIX,284571,284571,0,31326,31326,0,808.41793
20/03/2023 10:46,2022,80,UNITED STATES OF AMERICA,USA,1,HEATHROW,PITTSBURGH,37958,37958,0,0,0,0,0
20/03/2023 10:46,2022,80,UNITED STATES OF AMERICA,USA,1,HEATHROW,PORTLAND (OREGON),48840,48840,0,0,0,0,0
20/03/2023 10:46,2022,80,UNITED STATES OF AMERICA,USA,1,HEATHROW,RALEIGH,68451,68451,0,0,0,0,0
20/03/2023 10:46,2022,80,UNITED STATES OF AMERICA,USA,1,HEATHROW,SALT LAKE CITY,72839,72839,0,0,0,0,0
20/03/2023 10:46,2022,80,UNITED STATES OF AMERICA,USA,1,HEATHROW,SAN DIEGO,154420,154420,0,14374,14374,0,974.30082
20/03/2023 10:46,2022,80,UNITED STATES OF AMERICA,USA,1,HEATHROW,SAN FRANCISCO,878892,878892,0,157290,157203,87,458.7717
20/03/2023 10:46,2022,80,UNITED STATES OF AMERICA,USA,1,HEATHROW,SAN JOSE,52833,52833,0,0,0,0,0
20/03/2023 10:46,2022,80,UNITED STATES OF AMERICA,USA,1,HEATHROW,SEATTLE (TACOMA),365574,365574,0,77833,77833,0,369.69023
20/03/2023 10:46,2022,80,UNITED STATES OF AMERICA,USA,1,HEATHROW,TAMPA,17344,17344,0,0,0,0,0
20/03/2023 10:46,2022,80,UNITED STATES OF AMERICA,USA,1,HEATHROW,WASHINGTON (DULLES),626436,626436,0,188355,188355,0,232.58262
20/03/2023 10:46,2022,80,UNITED STATES OF AMERICA,USA,1,STANSTED,ATLANTA,0,0,0,139,0,139,-100
20/03/2023 10:46,2022,80,UNITED STATES OF AMERICA,USA,1,STANSTED,CINCINNATI,335,0,335,0,0,0,0
20/03/2023 10:46,2022,80,UNITED STATES OF AMERICA,USA,1,STANSTED,MIAMI INTERNATIONAL,0,0,0,160,0,160,-100
20/03/2023 10:46,2022,80,UNITED STATES OF AMERICA,USA,1,STANSTED,NEW YORK (NEWARK),206,0,206,294,0,294,-29.93197
20/03/2023 10:46,2022,80,UNITED STATES OF AMERICA,USA,1,STANSTED,ORLANDO,229,0,229,0,0,0,0
20/03/2023 10:46,2022,80,UNITED STATES OF AMERICA,USA,2,BELFAST CITY (GEORGE BEST),TETERBORO,3,0,3,0,0,0,0
20/03/2023 10:46,2022,80,UNITED STATES OF AMERICA,USA,2,BELFAST INTERNATIONAL,ORLANDO,1509,1509,0,0,0,0,0
20/03/2023 10:46,2022,80,UNITED STATES OF AMERICA,USA,2,BIGGIN HILL,WESTHAMPTON BEACH (FS GABRESKI),2,0,2,0,0,0,0
20/03/2023 10:46,2022,80,UNITED STATES OF AMERICA,USA,2,BIRMINGHAM,MELBOURNE FLATS,41524,0,41524,0,0,0,0
20/03/2023 10:46,2022,80,UNITED STATES OF AMERICA,USA,2,BIRMINGHAM,NEW YORK (JF KENNEDY),162,162,0,0,0,0,0
20/03/2023 10:46,2022,80,UNITED STATES OF AMERICA,USA,2,BRISTOL,MELBOURNE FLATS,19631,0,19631,0,0,0,0
20/03/2023 10:46,2022,80,UNITED STATES OF AMERICA,USA,2,DONCASTER SHEFFIELD,MELBOURNE FLATS,12990,0,12990,0,0,0,0
20/03/2023 10:46,2022,80,UNITED STATES OF AMERICA,USA,2,EDINBURGH,BOSTON,38354,38354,0,0,0,0,0
20/03/2023 10:46,2022,80,UNITED STATES OF AMERICA,USA,2,EDINBURGH,CHICAGO (O'HARE),21249,21249,0,0,0,0,0
20/03/2023 10:46,2022,80,UNITED STATES OF AMERICA,USA,2,EDINBURGH,DETROIT,0,0,0,24,0,24,-100
20/03/2023 10:46,2022,80,UNITED STATES OF AMERICA,USA,2,EDINBURGH,MELBOURNE FLATS,1771,0,1771,0,0,0,0
20/03/2023 10:46,2022,80,UNITED STATES OF AMERICA,USA,2,EDINBURGH,MINNEAPOLIS-ST PAUL,61,0,61,0,0,0,0
20/03/2023 10:46,2022,80,UNITED STATES OF AMERICA,USA,2,EDINBURGH,NEW YORK (JF KENNEDY),83355,83355,0,0,0,0,0
20/03/2023 10:46,2022,80,UNITED STATES OF AMERICA,USA,2,EDINBURGH,NEW YORK (NEWARK),94857,94857,0,0,0,0,0
20/03/2023 10:46,2022,80,UNITED STATES OF AMERICA,USA,2,EDINBURGH,ORLANDO,24836,24836,0,0,0,0,0
20/03/2023 10:46,2022,80,UNITED STATES OF AMERICA,USA,2,EDINBURGH,SAN FRANCISCO,3,3,0,0,0,0,0
20/03/2023 10:46,2022,80,UNITED STATES OF AMERICA,USA,2,EDINBURGH,WASHINGTON (DULLES),77268,77268,0,0,0,0,0
20/03/2023 10:46,2022,80,UNITED STATES OF AMERICA,USA,2,GLASGOW,DALLAS/FORT WORTH,223,223,0,0,0,0,0
20/03/2023 10:46,2022,80,UNITED STATES OF AMERICA,USA,2,GLASGOW,MELBOURNE FLATS,25692,0,25692,0,0,0,0
20/03/2023 10:46,2022,80,UNITED STATES OF AMERICA,USA,2,GLASGOW,NEW YORK (NEWARK),2,2,0,0,0,0,0
20/03/2023 10:46,2022,80,UNITED STATES OF AMERICA,USA,2,GLASGOW,PHILADELPHIA INTERNATIONAL,0,0,0,36,0,36,-100
20/03/2023 10:46,2022,80,UNITED STATES OF AMERICA,USA,2,LIVERPOOL (JOHN LENNON),MINNEAPOLIS-ST PAUL,79,0,79,0,0,0,0
20/03/2023 10:46,2022,80,UNITED STATES OF AMERICA,USA,2,LIVERPOOL (JOHN LENNON),PORTSMOUTH (USA),80,0,80,0,0,0,0
20/03/2023 10:46,2022,80,UNITED STATES OF AMERICA,USA,2,MANCHESTER,ATLANTA,86297,86297,0,3903,3903,0,2111.04279
20/03/2023 10:46,2022,80,UNITED STATES OF AMERICA,USA,2,MANCHESTER,BOSTON,2,2,0,0,0,0,0
20/03/2023 10:46,2022,80,UNITED STATES OF AMERICA,USA,2,MANCHESTER,CHARLOTTE,206,206,0,0,0,0,0
20/03/2023 10:46,2022,80,UNITED STATES OF AMERICA,USA,2,MANCHESTER,HOUSTON,29974,29974,0,1541,1541,0,1845.10058
20/03/2023 10:46,2022,80,UNITED STATES OF AMERICA,USA,2,MANCHESTER,MELBOURNE FLATS,76091,0,76091,0,0,0,0
20/03/2023 10:46,2022,80,UNITED STATES OF AMERICA,USA,2,MANCHESTER,NEW YORK (JF KENNEDY),249505,249505,0,24553,24553,0,916.18947
20/03/2023 10:46,2022,80,UNITED STATES OF AMERICA,USA,2,MANCHESTER,ORLANDO,307044,307044,0,21790,21676,114,1309.10509
20/03/2023 10:46,2022,80,UNITED STATES OF AMERICA,USA,2,NEWCASTLE,MELBOURNE FLATS,20347,20347,0,0,0,0,0
20/03/2023 10:46,2022,85,CENTRAL AMERICA,COSTA RICA,1,GATWICK,LIBERIA,27821,0,27821,2438,0,2438,1041.14028
20/03/2023 10:46,2022,85,CENTRAL AMERICA,COSTA RICA,1,GATWICK,SAN JOSE COST RICA,38932,38932,0,4670,4670,0,733.66167
20/03/2023 10:46,2022,85,CENTRAL AMERICA,CUBA,1,GATWICK,VARADERO,0,0,0,730,0,730,-100
20/03/2023 10:46,2022,85,CENTRAL AMERICA,CUBA,2,MANCHESTER,VARADERO,55105,0,55105,5248,0,5248,950.01905
20/03/2023 10:46,2022,85,CENTRAL AMERICA,DOMINICAN REPUBLIC,1,GATWICK,PUNTA CANA,179017,77173,101844,13109,5059,8050,1265.60378
20/03/2023 10:46,2022,85,CENTRAL AMERICA,DOMINICAN REPUBLIC,2,BIRMINGHAM,PUNTA CANA,35556,0,35556,0,0,0,0
20/03/2023 10:46,2022,85,CENTRAL AMERICA,DOMINICAN REPUBLIC,2,MANCHESTER,PUNTA CANA,114099,0,114099,7656,0,7656,1390.32132
20/03/2023 10:46,2022,85,CENTRAL AMERICA,MEXICO,1,GATWICK,CANCUN,401759,401474,285,76473,76473,0,425.36058
20/03/2023 10:46,2022,85,CENTRAL AMERICA,MEXICO,1,GATWICK,MEXICO CITY,0,0,0,66,66,0,-100
20/03/2023 10:46,2022,85,CENTRAL AMERICA,MEXICO,1,GATWICK,PUERTO VALLARTA,28710,0,28710,2929,0,2929,880.19802
20/03/2023 10:46,2022,85,CENTRAL AMERICA,MEXICO,1,HEATHROW,CANCUN,1,1,0,1091,1091,0,-99.90834
20/03/2023 10:46,2022,85,CENTRAL AMERICA,MEXICO,1,HEATHROW,MEXICO CITY,219943,219943,0,45564,44727,837,382.71223
20/03/2023 10:46,2022,85,CENTRAL AMERICA,MEXICO,2,BIRMINGHAM,CANCUN,83990,83701,289,9806,9806,0,756.51642
20/03/2023 10:46,2022,85,CENTRAL AMERICA,MEXICO,2,BRISTOL,CANCUN,29269,29269,0,0,0,0,0
20/03/2023 10:46,2022,85,CENTRAL AMERICA,MEXICO,2,DONCASTER SHEFFIELD,CANCUN,11138,9171,1967,0,0,0,0
20/03/2023 10:46,2022,85,CENTRAL AMERICA,MEXICO,2,EDINBURGH,CANCUN,2272,2272,0,0,0,0,0
20/03/2023 10:46,2022,85,CENTRAL AMERICA,MEXICO,2,GLASGOW,CANCUN,45485,38163,7322,0,0,0,0
20/03/2023 10:46,2022,85,CENTRAL AMERICA,MEXICO,2,MANCHESTER,CANCUN,191035,191035,0,21892,21892,0,772.6247
20/03/2023 10:46,2022,85,CENTRAL AMERICA,MEXICO,2,MANCHESTER,PUERTO VALLARTA,29548,0,29548,4777,0,4777,518.54721
20/03/2023 10:46,2022,85,CENTRAL AMERICA,MEXICO,2,NEWCASTLE,CANCUN,28249,28249,0,0,0,0,0
20/03/2023 10:46,2022,90,SOUTH AMERICA,ARGENTINA,1,HEATHROW,BUENOS AIRES,124981,124553,428,6583,6583,0,1798.5417
20/03/2023 10:46,2022,90,SOUTH AMERICA,BRAZIL,1,HEATHROW,RIO DE JANEIRO (GALEAO),85934,85933,1,6477,6477,0,1226.75621
20/03/2023 10:46,2022,90,SOUTH AMERICA,BRAZIL,1,HEATHROW,SAO PAULO (GUARULHOS),398189,398189,0,23066,22975,91,1626.30278
20/03/2023 10:46,2022,90,SOUTH AMERICA,BRAZIL,2,BELFAST INTERNATIONAL,MARECHAL CUNHA MACHADO INTERNATIONAL,0,0,0,35,0,35,-100
20/03/2023 10:46,2022,90,SOUTH AMERICA,CHILE,1,HEATHROW,SANTIAGO DE CHILE,60144,60144,0,5241,5241,0,1047.56726
20/03/2023 10:46,2022,90,SOUTH AMERICA,COLOMBIA,1,HEATHROW,BOGOTA,125965,125965,0,0,0,0,0
20/03/2023 10:46,2022,90,SOUTH AMERICA,GUYANA,1,HEATHROW,GEORGETOWN (GUYANA),0,0,0,964,0,964,-100
20/03/2023 10:46,2022,90,SOUTH AMERICA,GUYANA,1,STANSTED,GEORGETOWN (GUYANA),0,0,0,43,0,43,-100
20/03/2023 10:46,2022,90,SOUTH AMERICA,SURINAM,1,STANSTED,PARAMARIBO,0,0,0,16,0,16,-100
20/03/2023 10:46,2022,95,CARIBBEAN AREA,ANTIGUA AND BARBUDA,1,GATWICK,ANTIGUA,113636,113636,0,71290,71290,0,59.39964
20/03/2023 10:46,2022,95,CARIBBEAN AREA,ANTIGUA AND BARBUDA,1,HEATHROW,ANTIGUA,69821,69788,33,32702,32702,0,113.50682
20/03/2023 10:46,2022,95,CARIBBEAN AREA,BAHAMAS,1,HEATHROW,NASSAU,62347,62051,296,37251,37251,0,67.37
20/03/2023 10:46,2022,95,CARIBBEAN AREA,BARBADOS,1,GATWICK,BRIDGETOWN,90457,48921,41536,26483,17008,9475,241.56629
20/03/2023 10:46,2022,95,CARIBBEAN AREA,BARBADOS,1,HEATHROW,BRIDGETOWN,330203,327929,2274,159048,159048,0,107.61217
20/03/2023 10:46,2022,95,CARIBBEAN AREA,BARBADOS,2,BELFAST INTERNATIONAL,BRIDGETOWN,584,0,584,0,0,0,0
20/03/2023 10:46,2022,95,CARIBBEAN AREA,BARBADOS,2,BIRMINGHAM,BRIDGETOWN,27166,0,27166,4735,0,4735,473.72756
20/03/2023 10:46,2022,95,CARIBBEAN AREA,BARBADOS,2,BOURNEMOUTH,BRIDGETOWN,972,0,972,0,0,0,0
20/03/2023 10:46,2022,95,CARIBBEAN AREA,BARBADOS,2,CARDIFF WALES,BRIDGETOWN,1766,0,1766,283,0,283,524.02827
20/03/2023 10:46,2022,95,CARIBBEAN AREA,BARBADOS,2,EDINBURGH,BRIDGETOWN,2209,2209,0,707,707,0,212.44696
20/03/2023 10:46,2022,95,CARIBBEAN AREA,BARBADOS,2,GLASGOW,BRIDGETOWN,2968,0,2968,798,0,798,271.92982
20/03/2023 10:46,2022,95,CARIBBEAN AREA,BARBADOS,2,MANCHESTER,BRIDGETOWN,107146,60431,46715,36849,25305,11544,190.77044
20/03/2023 10:46,2022,95,CARIBBEAN AREA,BARBADOS,2,NEWCASTLE,BRIDGETOWN,1856,1680,176,0,0,0,0
20/03/2023 10:46,2022,95,CARIBBEAN AREA,BERMUDA,1,GATWICK,BERMUDA,0,0,0,3043,3043,0,-100
20/03/2023 10:46,2022,95,CARIBBEAN AREA,BERMUDA,1,HEATHROW,BERMUDA,86893,86893,0,40224,40224,0,116.02277
20/03/2023 10:46,2022,95,CARIBBEAN AREA,BERMUDA,2,LIVERPOOL (JOHN LENNON),BERMUDA,37,0,37,0,0,0,0
20/03/2023 10:46,2022,95,CARIBBEAN AREA,CAYMAN ISLANDS,1,HEATHROW,GRAND CAYMAN,64110,64110,0,10142,10142,0,532.12384
20/03/2023 10:46,2022,95,CARIBBEAN AREA,GRENADA,1,GATWICK,GRENADA,33969,33969,0,8435,8435,0,302.71488
20/03/2023 10:46,2022,95,CARIBBEAN AREA,GRENADA,1,HEATHROW,GRENADA,20823,20823,0,3161,3161,0,558.74723
20/03/2023 10:46,2022,95,CARIBBEAN AREA,ISLE OF CURACAO NETH.ANTILLES,1,GATWICK,ARUBA,14283,0,14283,274,0,274,5112.77372
20/03/2023 10:46,2022,95,CARIBBEAN AREA,JAMAICA,1,GATWICK,KINGSTON,99861,99811,50,48508,48382,126,105.86501
20/03/2023 10:46,2022,95,CARIBBEAN AREA,JAMAICA,1,GATWICK,MONTEGO BAY,120883,18335,102548,40572,16998,23574,197.94686
20/03/2023 10:46,2022,95,CARIBBEAN AREA,JAMAICA,1,HEATHROW,MONTEGO BAY,90166,90166,0,27325,27325,0,229.97621
20/03/2023 10:46,2022,95,CARIBBEAN AREA,JAMAICA,2,BIRMINGHAM,MONTEGO BAY,62447,0,62447,7204,0,7204,766.83787
20/03/2023 10:46,2022,95,CARIBBEAN AREA,JAMAICA,2,BRISTOL,MONTEGO BAY,301,0,301,0,0,0,0
20/03/2023 10:46,2022,95,CARIBBEAN AREA,JAMAICA,2,GLASGOW,MONTEGO BAY,2076,0,2076,0,0,0,0
20/03/2023 10:46,2022,95,CARIBBEAN AREA,JAMAICA,2,MANCHESTER,MONTEGO BAY,94166,0,94166,18291,0,18291,414.8215
20/03/2023 10:46,2022,95,CARIBBEAN AREA,JAMAICA,2,NEWCASTLE,MONTEGO BAY,476,476,0,0,0,0,0
20/03/2023 10:46,2022,95,CARIBBEAN AREA,SAINT KITTS AND NEVIS,1,GATWICK,ST KITTS,15707,15707,0,3558,3558,0,341.45587
20/03/2023 10:46,2022,95,CARIBBEAN AREA,SAINT VINCENT AND THE GRENADINES,1,HEATHROW,E T JOSHUA,21865,21865,0,1530,1530,0,1329.08497
20/03/2023 10:46,2022,95,CARIBBEAN AREA,ST LUCIA,1,GATWICK,ST LUCIA (HEWANORRA),142621,112963,29658,59390,44777,14613,140.14312
20/03/2023 10:46,2022,95,CARIBBEAN AREA,ST LUCIA,1,HEATHROW,ST LUCIA (HEWANORRA),37794,37526,268,11240,11240,0,236.24555
20/03/2023 10:46,2022,95,CARIBBEAN AREA,ST LUCIA,2,MANCHESTER,ST LUCIA (HEWANORRA),0,0,0,541,0,541,-100
20/03/2023 10:46,2022,95,CARIBBEAN AREA,TRINIDAD AND TOBAGO,1,GATWICK,PORT OF SPAIN,52928,52928,0,4880,4880,0,984.59016
20/03/2023 10:46,2022,95,CARIBBEAN AREA,TRINIDAD AND TOBAGO,1,GATWICK,TOBAGO,17668,17668,0,0,0,0,0
20/03/2023 10:46,2022,95,CARIBBEAN AREA,TRINIDAD AND TOBAGO,1,HEATHROW,TOBAGO,11915,11915,0,0,0,0,0
20/03/2023 10:46,2022,95,CARIBBEAN AREA,TURKS AND CAICOS ISLANDS,1,GATWICK,PROVIDENCIALES,8372,8372,0,6183,6183,0,35.40353
20/03/2023 10:46,2022,95,CARIBBEAN AREA,TURKS AND CAICOS ISLANDS,1,HEATHROW,PROVIDENCIALES,5628,5628,0,1231,1231,0,357.18928
20/03/2023 10:46,2022,100,INDIAN OCEAN ISLANDS,MALDIVE ISLANDS,1,HEATHROW,MALE INTERNATIONAL,75844,75844,0,43221,43221,0,75.47951
20/03/2023 10:46,2022,100,INDIAN OCEAN ISLANDS,MAURITIUS,1,GATWICK,MAURITIUS,95897,95897,0,28560,28560,0,235.77381
20/03/2023 10:46,2022,100,INDIAN OCEAN ISLANDS,MAURITIUS,1,HEATHROW,MAURITIUS,110362,110362,0,21354,21354,0,416.8212
20/03/2023 10:46,2022,100,INDIAN OCEAN ISLANDS,SEYCHELLES,1,HEATHROW,SEYCHELLES,0,0,0,272,272,0,-100
20/03/2023 10:46,2022,105,ATLANTIC OCEAN ISLANDS,ASCENSION ISLAND,1,STANSTED,SAINT HELENA,627,0,627,1280,0,1280,-51.01562
20/03/2023 10:46,2022,105,ATLANTIC OCEAN ISLANDS,CAPE VERDE ISLANDS,1,GATWICK,BOA VISTA (RABIL),63018,62834,184,6575,6575,0,858.44867
20/03/2023 10:46,2022,105,ATLANTIC OCEAN ISLANDS,CAPE VERDE ISLANDS,1,GATWICK,ILHA DO SAL C.VERDE,73102,72805,297,8073,8073,0,805.5122
20/03/2023 10:46,2022,105,ATLANTIC OCEAN ISLANDS,CAPE VERDE ISLANDS,1,GATWICK,PRAIA,195,0,195,0,0,0,0
20/03/2023 10:46,2022,105,ATLANTIC OCEAN ISLANDS,CAPE VERDE ISLANDS,1,STANSTED,PRAIA,0,0,0,25,0,25,-100
20/03/2023 10:46,2022,105,ATLANTIC OCEAN ISLANDS,CAPE VERDE ISLANDS,2,BIRMINGHAM,BOA VISTA (RABIL),36103,36103,0,2968,2968,0,1116.40836
20/03/2023 10:46,2022,105,ATLANTIC OCEAN ISLANDS,CAPE VERDE ISLANDS,2,BIRMINGHAM,ILHA DO SAL C.VERDE,44083,43187,896,3304,3304,0,1234.23123
20/03/2023 10:46,2022,105,ATLANTIC OCEAN ISLANDS,CAPE VERDE ISLANDS,2,BRISTOL,ILHA DO SAL C.VERDE,20684,20684,0,566,566,0,3554.41696
20/03/2023 10:46,2022,105,ATLANTIC OCEAN ISLANDS,CAPE VERDE ISLANDS,2,MANCHESTER,BOA VISTA (RABIL),61107,61107,0,6387,6387,0,856.74025
20/03/2023 10:46,2022,105,ATLANTIC OCEAN ISLANDS,CAPE VERDE ISLANDS,2,MANCHESTER,ILHA DO SAL C.VERDE,69390,69001,389,7802,7802,0,789.38734
20/03/2023 10:46,2022,105,ATLANTIC OCEAN ISLANDS,CAPE VERDE ISLANDS,2,NEWCASTLE,PRAIA,73,0,73,0,0,0,0
20/03/2023 10:46,2022,105,ATLANTIC OCEAN ISLANDS,GREENLAND,1,STANSTED,SONDRE STROMFJORD,0,0,0,431,0,431,-100
20/03/2023 10:46,2022,115,OIL RIGS,OIL RIGS,2,ABERDEEN,OIL RIGS,349263,0,349263,321890,0,321890,8.50384
20/03/2023 10:46,2022,115,OIL RIGS,OIL RIGS,2,BLACKPOOL,OIL RIGS,9428,0,9428,0,0,0,0
20/03/2023 10:46,2022,115,OIL RIGS,OIL RIGS,2,HUMBERSIDE,OIL RIGS,11190,0,11190,14224,0,14224,-21.33015
20/03/2023 10:46,2022,115,OIL RIGS,OIL RIGS,2,KIRKWALL,OIL RIGS,24,0,24,76,0,76,-68.42105
20/03/2023 10:46,2022,115,OIL RIGS,OIL RIGS,2,NORWICH,OIL RIGS,83751,0,83751,70894,0,70894,18.13553
20/03/2023 10:46,2022,115,OIL RIGS,OIL RIGS,2,STORNOWAY,OIL RIGS,15,0,15,0,0,0,0
20/03/2023 10:46,2022,115,OIL RIGS,OIL RIGS,2,SUMBURGH,OIL RIGS,74183,0,74183,67292,0,67292,10.24044

