rundate,this_period,foreign_region,foreign_country,UK_airport,foreign_airport,total_pax_this_period,total_pax_scheduled_this_period,total_pax_charter_this_period,total_pax_last_period,total_pax_scheduled_last_period,total_pax_charter_last_period,total_pax_percent
15/02/2023 17:21,202212,WESTERN EUROPE-EU,AUSTRIA,GATWICK,INNSBRUCK,23535,19811,3724,9204,8134,1070,155.704042
15/02/2023 17:21,202212,WESTERN EUROPE-EU,AUSTRIA,GATWICK,SALZBURG,20018,18957,1061,1793,1479,314,1016.452872
15/02/2023 17:21,202212,WESTERN EUROPE-EU,AUSTRIA,GATWICK,VIENNA,19280,19280,0,0,0,0,0
15/02/2023 17:21,202212,WESTERN EUROPE-EU,AUSTRIA,HEATHROW,INNSBRUCK,6711,6711,0,2541,2541,0,164.108619
15/02/2023 17:21,202212,WESTERN EUROPE-EU,AUSTRIA,HEATHROW,SALZBURG,2255,2255,0,2419,2419,0,-6.779661
15/02/2023 17:21,202212,WESTERN EUROPE-EU,AUSTRIA,HEATHROW,VIENNA,63441,63441,0,16623,16623,0,281.645912
15/02/2023 17:21,202212,WESTERN EUROPE-EU,AUSTRIA,LONDON CITY,SALZBURG,762,762,0,0,0,0,0
15/02/2023 17:21,202212,WESTERN EUROPE-EU,AUSTRIA,LUTON,INNSBRUCK,1232,420,812,679,307,372,81.443299
15/02/2023 17:21,202212,WESTERN EUROPE-EU,AUSTRIA,LUTON,SALZBURG,1618,1618,0,492,492,0,228.861789
15/02/2023 17:21,202212,WESTERN EUROPE-EU,AUSTRIA,LUTON,VIENNA,0,0,0,3265,3265,0,-100
15/02/2023 17:21,202212,WESTERN EUROPE-EU,AUSTRIA,STANSTED,INNSBRUCK,1369,478,891,563,295,268,143.161634
15/02/2023 17:21,202212,WESTERN EUROPE-EU,AUSTRIA,STANSTED,KLAGENFURT,2573,2573,0,0,0,0,0
15/02/2023 17:21,202212,WESTERN EUROPE-EU,AUSTRIA,STANSTED,SALZBURG,8924,8738,186,3046,2976,70,192.974393
15/02/2023 17:21,202212,WESTERN EUROPE-EU,AUSTRIA,STANSTED,VIENNA,22621,22621,0,7494,7494,0,201.854817
15/02/2023 17:21,202212,WESTERN EUROPE-EU,AUSTRIA,BELFAST INTERNATIONAL,SALZBURG,460,0,460,41,41,0,1021.95122
15/02/2023 17:21,202212,WESTERN EUROPE-EU,AUSTRIA,BIGGIN HILL,SALZBURG,0,0,0,12,0,12,-100
15/02/2023 17:21,202212,WESTERN EUROPE-EU,AUSTRIA,BIGGIN HILL,VIENNA,0,0,0,1,0,1,-100
15/02/2023 17:21,202212,WESTERN EUROPE-EU,AUSTRIA,BIRMINGHAM,INNSBRUCK,2666,1012,1654,774,346,428,244.444444
15/02/2023 17:21,202212,WESTERN EUROPE-EU,AUSTRIA,BIRMINGHAM,SALZBURG,1125,634,491,442,231,211,154.524887
15/02/2023 17:21,202212,WESTERN EUROPE-EU,AUSTRIA,BIRMINGHAM,VIENNA,2287,2287,0,0,0,0,0
15/02/2023 17:21,202212,WESTERN EUROPE-EU,AUSTRIA,BRISTOL,INNSBRUCK,3651,2795,856,1167,936,231,212.85347
15/02/2023 17:21,202212,WESTERN EUROPE-EU,AUSTRIA,BRISTOL,SALZBURG,1941,1521,420,402,335,67,382.835821
15/02/2023 17:21,202212,WESTERN EUROPE-EU,AUSTRIA,BRISTOL,VIENNA,3772,3772,0,866,866,0,335.56582
15/02/2023 17:21,202212,WESTERN EUROPE-EU,AUSTRIA,EAST MIDLANDS INTERNATIONAL,SALZBURG,555,210,345,133,38,95,317.293233
15/02/2023 17:21,202212,WESTERN EUROPE-EU,AUSTRIA,EDINBURGH,INNSBRUCK,894,383,511,271,149,122,229.889299
15/02/2023 17:21,202212,WESTERN EUROPE-EU,AUSTRIA,EDINBURGH,SALZBURG,391,391,0,173,173,0,126.011561
15/02/2023 17:21,202212,WESTERN EUROPE-EU,AUSTRIA,EDINBURGH,VIENNA,4065,4065,0,1848,1848,0,119.967532
15/02/2023 17:21,202212,WESTERN EUROPE-EU,AUSTRIA,GLASGOW,SALZBURG,189,0,189,0,0,0,0
15/02/2023 17:21,202212,WESTERN EUROPE-EU,AUSTRIA,LEEDS BRADFORD,SALZBURG,525,525,0,143,143,0,267.132867
15/02/2023 17:21,202212,WESTERN EUROPE-EU,AUSTRIA,LEEDS BRADFORD,VIENNA,1551,1551,0,0,0,0,0
15/02/2023 17:21,202212,WESTERN EUROPE-EU,AUSTRIA,LIVERPOOL (JOHN LENNON),SALZBURG,746,746,0,162,162,0,360.493827
15/02/2023 17:21,202212,WESTERN EUROPE-EU,AUSTRIA,LIVERPOOL (JOHN LENNON),VIENNA,2554,2554,0,663,663,0,285.218703
15/02/2023 17:21,202212,WESTERN EUROPE-EU,AUSTRIA,MANCHESTER,INNSBRUCK,5321,3577,1744,1347,872,475,295.025984
15/02/2023 17:21,202212,WESTERN EUROPE-EU,AUSTRIA,MANCHESTER,KLAGENFURT,384,384,0,0,0,0,0
15/02/2023 17:21,202212,WESTERN EUROPE-EU,AUSTRIA,MANCHESTER,SALZBURG,2970,2117,853,853,582,271,248.182884
15/02/2023 17:21,202212,WESTERN EUROPE-EU,AUSTRIA,MANCHESTER,VIENNA,9936,9936,0,1303,1303,0,662.547966
15/02/2023 17:21,202212,WESTERN EUROPE-EU,AUSTRIA,NEWCASTLE,INNSBRUCK,528,528,0,130,130,0,306.153846
15/02/2023 17:21,202212,WESTERN EUROPE-EU,AUSTRIA,NEWCASTLE,SALZBURG,293,293,0,0,0,0,0
15/02/2023 17:21,202212,WESTERN EUROPE-EU,AUSTRIA,NEWCASTLE,VIENNA,1761,1761,0,0,0,0,0
15/02/2023 17:21,202212,WESTERN EUROPE-EU,AUSTRIA,SOUTHAMPTON,SALZBURG,327,327,0,0,0,0,0
15/02/2023 17:21,202212,WESTERN EUROPE-EU,BELGIUM,HEATHROW,BRUSSELS,53200,53200,0,15552,15552,0,242.078189
15/02/2023 17:21,202212,WESTERN EUROPE-EU,BELGIUM,LUTON,OSTEND,130,130,0,0,0,0,0
15/02/2023 17:21,202212,WESTERN EUROPE-EU,BELGIUM,STANSTED,BRUSSELS,247,247,0,0,0,0,0
15/02/2023 17:21,202212,WESTERN EUROPE-EU,BELGIUM,BIRMINGHAM,BRUSSELS,9093,9093,0,758,758,0,1099.604222
15/02/2023 17:21,202212,WESTERN EUROPE-EU,BELGIUM,BIRMINGHAM,CHARLEROI,202,202,0,0,0,0,0
15/02/2023 17:21,202212,WESTERN EUROPE-EU,BELGIUM,EDINBURGH,BRUSSELS,3549,3549,0,604,604,0,487.582781
15/02/2023 17:21,202212,WESTERN EUROPE-EU,BELGIUM,EDINBURGH,CHARLEROI,9614,9614,0,2952,2952,0,225.677507
15/02/2023 17:21,202212,WESTERN EUROPE-EU,BELGIUM,GLASGOW,CHARLEROI,1916,1916,0,0,0,0,0
15/02/2023 17:21,202212,WESTERN EUROPE-EU,BELGIUM,LIVERPOOL (JOHN LENNON),CHARLEROI,2018,2018,0,0,0,0,0
15/02/2023 17:21,202212,WESTERN EUROPE-EU,BELGIUM,MANCHESTER,BRUSSELS,13451,13451,0,4956,4956,0,171.408394
15/02/2023 17:21,202212,WESTERN EUROPE-EU,BELGIUM,MANCHESTER,CHARLEROI,18264,18264,0,5906,5906,0,209.244836
15/02/2023 17:21,202212,WESTERN EUROPE-EU,BELGIUM,PRESTWICK,CHARLEROI,47,47,0,0,0,0,0
15/02/2023 17:21,202212,WESTERN EUROPE-EU,CROATIA,GATWICK,DUBROVNIK,1189,1189,0,0,0,0,0
15/02/2023 17:21,202212,WESTERN EUROPE-EU,CROATIA,GATWICK,SPLIT,12,0,12,0,0,0,0
15/02/2023 17:21,202212,WESTERN EUROPE-EU,CROATIA,HEATHROW,ZAGREB,9109,9109,0,4426,4426,0,105.806597
15/02/2023 17:21,202212,WESTERN EUROPE-EU,CROATIA,STANSTED,ZAGREB,9038,9038,0,4998,4998,0,80.832333
15/02/2023 17:21,202212,WESTERN EUROPE-EU,CROATIA,MANCHESTER,ZAGREB,2546,2546,0,1454,1454,0,75.103164
15/02/2023 17:21,202212,WESTERN EUROPE-EU,CYPRUS,GATWICK,LARNACA,20016,20016,0,5212,5212,0,284.036838
15/02/2023 17:21,202212,WESTERN EUROPE-EU,CYPRUS,GATWICK,PAPHOS,9053,9053,0,5554,5554,0,62.99964
15/02/2023 17:21,202212,WESTERN EUROPE-EU,CYPRUS,HEATHROW,LARNACA,18717,18717,0,17305,17305,0,8.159491
15/02/2023 17:21,202212,WESTERN EUROPE-EU,CYPRUS,LUTON,LARNACA,12580,12580,0,8139,8139,0,54.564443
15/02/2023 17:21,202212,WESTERN EUROPE-EU,CYPRUS,LUTON,PAPHOS,2097,2097,0,995,995,0,110.753769
15/02/2023 17:21,202212,WESTERN EUROPE-EU,CYPRUS,STANSTED,PAPHOS,13902,13902,0,9291,9291,0,49.628673
15/02/2023 17:21,202212,WESTERN EUROPE-EU,CYPRUS,BIGGIN HILL,PAPHOS,4,0,4,0,0,0,0
15/02/2023 17:21,202212,WESTERN EUROPE-EU,CYPRUS,BIRMINGHAM,PAPHOS,1365,1365,0,1098,1098,0,24.31694
15/02/2023 17:21,202212,WESTERN EUROPE-EU,CYPRUS,BRISTOL,LARNACA,0,0,0,1436,1436,0,-100
15/02/2023 17:21,202212,WESTERN EUROPE-EU,CYPRUS,BRISTOL,PAPHOS,2929,2929,0,1956,1956,0,49.744376
15/02/2023 17:21,202212,WESTERN EUROPE-EU,CYPRUS,DONCASTER SHEFFIELD,LARNACA,0,0,0,1064,1064,0,-100
15/02/2023 17:21,202212,WESTERN EUROPE-EU,CYPRUS,EDINBURGH,PAPHOS,2907,2907,0,1962,1962,0,48.165138
15/02/2023 17:21,202212,WESTERN EUROPE-EU,CYPRUS,LIVERPOOL (JOHN LENNON),LARNACA,2663,2663,0,0,0,0,0
15/02/2023 17:21,202212,WESTERN EUROPE-EU,CYPRUS,MANCHESTER,PAPHOS,11655,11655,0,7420,7420,0,57.075472
15/02/2023 17:21,202212,WESTERN EUROPE-EU,DENMARK,GATWICK,COPENHAGEN,48177,48177,0,14780,14780,0,225.960758
15/02/2023 17:21,202212,WESTERN EUROPE-EU,DENMARK,HEATHROW,BILLUND,5852,5852,0,0,0,0,0
15/02/2023 17:21,202212,WESTERN EUROPE-EU,DENMARK,HEATHROW,COPENHAGEN,67585,67585,0,26589,26589,0,154.184061
15/02/2023 17:21,202212,WESTERN EUROPE-EU,DENMARK,LONDON CITY,BILLUND,431,431,0,0,0,0,0
15/02/2023 17:21,202212,WESTERN EUROPE-EU,DENMARK,STANSTED,AALBORG,2845,2845,0,1741,1741,0,63.411832
15/02/2023 17:21,202212,WESTERN EUROPE-EU,DENMARK,STANSTED,AARHUS (TIRSTRUP),6500,6500,0,3557,3557,0,82.738263
15/02/2023 17:21,202212,WESTERN EUROPE-EU,DENMARK,STANSTED,BILLUND,18491,18491,0,7218,7218,0,156.178997
15/02/2023 17:21,202212,WESTERN EUROPE-EU,DENMARK,STANSTED,COPENHAGEN,27245,27245,0,15141,15141,0,79.94188
15/02/2023 17:21,202212,WESTERN EUROPE-EU,DENMARK,ABERDEEN,COPENHAGEN,293,293,0,0,0,0,0
15/02/2023 17:21,202212,WESTERN EUROPE-EU,DENMARK,ABERDEEN,ESBJERG,562,562,0,458,458,0,22.707424
15/02/2023 17:21,202212,WESTERN EUROPE-EU,DENMARK,BIRMINGHAM,BILLUND,1980,1980,0,0,0,0,0
15/02/2023 17:21,202212,WESTERN EUROPE-EU,DENMARK,BIRMINGHAM,COPENHAGEN,2432,2432,0,0,0,0,0
15/02/2023 17:21,202212,WESTERN EUROPE-EU,DENMARK,BRISTOL,COPENHAGEN,2935,2935,0,0,0,0,0
15/02/2023 17:21,202212,WESTERN EUROPE-EU,DENMARK,CAMPBELTOWN,BILLUND,19,0,19,0,0,0,0
15/02/2023 17:21,202212,WESTERN EUROPE-EU,DENMARK,EAST MIDLANDS INTERNATIONAL,COPENHAGEN,0,0,0,200,200,0,-100
15/02/2023 17:21,202212,WESTERN EUROPE-EU,DENMARK,EDINBURGH,BILLUND,2422,2422,0,813,813,0,197.908979
15/02/2023 17:21,202212,WESTERN EUROPE-EU,DENMARK,EDINBURGH,COPENHAGEN,12366,12366,0,5210,5210,0,137.351248
15/02/2023 17:21,202212,WESTERN EUROPE-EU,DENMARK,HUMBERSIDE,ESBJERG,142,142,0,0,0,0,0
15/02/2023 17:21,202212,WESTERN EUROPE-EU,DENMARK,LIVERPOOL (JOHN LENNON),COPENHAGEN,2488,2488,0,1008,1008,0,146.825397
15/02/2023 17:21,202212,WESTERN EUROPE-EU,DENMARK,MANCHESTER,BILLUND,4036,4036,0,1879,1879,0,114.795104
15/02/2023 17:21,202212,WESTERN EUROPE-EU,DENMARK,MANCHESTER,COPENHAGEN,28346,28346,0,12790,12790,0,121.626271
15/02/2023 17:21,202212,WESTERN EUROPE-EU,DENMARK,NEWCASTLE,COPENHAGEN,1122,1122,0,250,250,0,348.8
15/02/2023 17:21,202212,WESTERN EUROPE-EU,FINLAND,GATWICK,ENONTEKIO,4015,0,4015,2672,0,2672,50.261976
15/02/2023 17:21,202212,WESTERN EUROPE-EU,FINLAND,GATWICK,HELSINKI,7739,7739,0,2069,2069,0,274.045433
15/02/2023 17:21,202212,WESTERN EUROPE-EU,FINLAND,GATWICK,IVALO,6333,0,6333,5906,0,5906,7.229936
15/02/2023 17:21,202212,WESTERN EUROPE-EU,FINLAND,GATWICK,KITTILA,10752,0,10752,10086,407,9679,6.603212
15/02/2023 17:21,202212,WESTERN EUROPE-EU,FINLAND,GATWICK,KUUSAMO,4483,0,4483,4000,0,4000,12.075
15/02/2023 17:21,202212,WESTERN EUROPE-EU,FINLAND,GATWICK,ROVANIEMI,15790,4500,11290,14961,4649,10312,5.541073
15/02/2023 17:21,202212,WESTERN EUROPE-EU,FINLAND,HEATHROW,HELSINKI,41997,41997,0,24958,24958,0,68.270695
15/02/2023 17:21,202212,WESTERN EUROPE-EU,FINLAND,HEATHROW,KITTILA,2319,0,2319,2007,0,2007,15.54559
15/02/2023 17:21,202212,WESTERN EUROPE-EU,FINLAND,LUTON,IVALO,866,0,866,803,0,803,7.845579
15/02/2023 17:21,202212,WESTERN EUROPE-EU,FINLAND,STANSTED,ENONTEKIO,2068,0,2068,1926,0,1926,7.372793
15/02/2023 17:21,202212,WESTERN EUROPE-EU,FINLAND,STANSTED,HELSINKI,10870,10870,0,7503,7503,0,44.875383
15/02/2023 17:21,202212,WESTERN EUROPE-EU,FINLAND,STANSTED,IVALO,3034,0,3034,2160,0,2160,40.462963
15/02/2023 17:21,202212,WESTERN EUROPE-EU,FINLAND,STANSTED,KITTILA,559,191,368,240,0,240,132.916667
15/02/2023 17:21,202212,WESTERN EUROPE-EU,FINLAND,STANSTED,KUUSAMO,3900,0,3900,2397,0,2397,62.703379
15/02/2023 17:21,202212,WESTERN EUROPE-EU,FINLAND,STANSTED,ROVANIEMI,6199,6199,0,0,0,0,0
15/02/2023 17:21,202212,WESTERN EUROPE-EU,FINLAND,STANSTED,TAMPERE,3623,3623,0,1172,1172,0,209.129693
15/02/2023 17:21,202212,WESTERN EUROPE-EU,FINLAND,ABERDEEN,ENONTEKIO,0,0,0,718,0,718,-100
15/02/2023 17:21,202212,WESTERN EUROPE-EU,FINLAND,BELFAST INTERNATIONAL,ENONTEKIO,556,0,556,1257,0,1257,-55.767701
15/02/2023 17:21,202212,WESTERN EUROPE-EU,FINLAND,BELFAST INTERNATIONAL,IVALO,13,0,13,0,0,0,0
15/02/2023 17:21,202212,WESTERN EUROPE-EU,FINLAND,BELFAST INTERNATIONAL,ROVANIEMI,378,0,378,0,0,0,0
15/02/2023 17:21,202212,WESTERN EUROPE-EU,FINLAND,BIGGIN HILL,KITTILA,16,0,16,0,0,0,0
15/02/2023 17:21,202212,WESTERN EUROPE-EU,FINLAND,BIGGIN HILL,ROVANIEMI,32,0,32,0,0,0,0
15/02/2023 17:21,202212,WESTERN EUROPE-EU,FINLAND,BIRMINGHAM,ENONTEKIO,2400,0,2400,1883,0,1883,27.456187
15/02/2023 17:21,202212,WESTERN EUROPE-EU,FINLAND,BIRMINGHAM,IVALO,4306,0,4306,3687,0,3687,16.788717
15/02/2023 17:21,202212,WESTERN EUROPE-EU,FINLAND,BIRMINGHAM,KITTILA,3741,0,3741,2826,0,2826,32.377919
15/02/2023 17:21,202212,WESTERN EUROPE-EU,FINLAND,BIRMINGHAM,KUUSAMO,1131,0,1131,1074,0,1074,5.307263
15/02/2023 17:21,202212,WESTERN EUROPE-EU,FINLAND,BIRMINGHAM,ROVANIEMI,2440,0,2440,2363,0,2363,3.25857
15/02/2023 17:21,202212,WESTERN EUROPE-EU,FINLAND,BOURNEMOUTH,ENONTEKIO,370,0,370,0,0,0,0
15/02/2023 17:21,202212,WESTERN EUROPE-EU,FINLAND,BOURNEMOUTH,IVALO,437,0,437,0,0,0,0
15/02/2023 17:21,202212,WESTERN EUROPE-EU,FINLAND,BRISTOL,ENONTEKIO,1878,0,1878,1028,0,1028,82.684825
15/02/2023 17:21,202212,WESTERN EUROPE-EU,FINLAND,BRISTOL,IVALO,1268,0,1268,1342,0,1342,-5.514158
15/02/2023 17:21,202212,WESTERN EUROPE-EU,FINLAND,BRISTOL,KITTILA,5577,14,5563,5332,6,5326,4.594899
15/02/2023 17:21,202212,WESTERN EUROPE-EU,FINLAND,BRISTOL,ROVANIEMI,5316,2875,2441,2369,0,2369,124.39848
15/02/2023 17:21,202212,WESTERN EUROPE-EU,FINLAND,CARDIFF WALES,ENONTEKIO,376,0,376,342,0,342,9.94152
15/02/2023 17:21,202212,WESTERN EUROPE-EU,FINLAND,CARDIFF WALES,IVALO,431,0,431,363,0,363,18.732782
15/02/2023 17:21,202212,WESTERN EUROPE-EU,FINLAND,DONCASTER SHEFFIELD,ENONTEKIO,0,0,0,318,0,318,-100
15/02/2023 17:21,202212,WESTERN EUROPE-EU,FINLAND,DONCASTER SHEFFIELD,KITTILA,0,0,0,2724,0,2724,-100
15/02/2023 17:21,202212,WESTERN EUROPE-EU,FINLAND,EAST MIDLANDS INTERNATIONAL,ENONTEKIO,541,0,541,704,0,704,-23.153409
15/02/2023 17:21,202212,WESTERN EUROPE-EU,FINLAND,EAST MIDLANDS INTERNATIONAL,IVALO,868,0,868,0,0,0,0
15/02/2023 17:21,202212,WESTERN EUROPE-EU,FINLAND,EAST MIDLANDS INTERNATIONAL,KITTILA,3168,0,3168,2718,0,2718,16.556291
15/02/2023 17:21,202212,WESTERN EUROPE-EU,FINLAND,EAST MIDLANDS INTERNATIONAL,ROVANIEMI,0,0,0,180,0,180,-100
15/02/2023 17:21,202212,WESTERN EUROPE-EU,FINLAND,EDINBURGH,ENONTEKIO,1319,189,1130,738,0,738,78.726287
15/02/2023 17:21,202212,WESTERN EUROPE-EU,FINLAND,EDINBURGH,HELSINKI,2623,2623,0,1568,1568,0,67.283163
15/02/2023 17:21,202212,WESTERN EUROPE-EU,FINLAND,EDINBURGH,IVALO,849,0,849,388,0,388,118.814433
15/02/2023 17:21,202212,WESTERN EUROPE-EU,FINLAND,EDINBURGH,KITTILA,0,0,0,2231,0,2231,-100
15/02/2023 17:21,202212,WESTERN EUROPE-EU,FINLAND,EXETER,ENONTEKIO,372,0,372,0,0,0,0
15/02/2023 17:21,202212,WESTERN EUROPE-EU,FINLAND,GLASGOW,ENONTEKIO,1114,0,1114,1442,0,1442,-22.746186
15/02/2023 17:21,202212,WESTERN EUROPE-EU,FINLAND,GLASGOW,IVALO,430,0,430,392,0,392,9.693878
15/02/2023 17:21,202212,WESTERN EUROPE-EU,FINLAND,GLASGOW,KITTILA,3163,0,3163,342,0,342,824.853801
15/02/2023 17:21,202212,WESTERN EUROPE-EU,FINLAND,HUMBERSIDE,ENONTEKIO,1070,0,1070,735,0,735,45.578231
15/02/2023 17:21,202212,WESTERN EUROPE-EU,FINLAND,LEEDS BRADFORD,ENONTEKIO,1848,0,1848,174,0,174,962.068966
15/02/2023 17:21,202212,WESTERN EUROPE-EU,FINLAND,LEEDS BRADFORD,IVALO,938,0,938,1447,0,1447,-35.176227
15/02/2023 17:21,202212,WESTERN EUROPE-EU,FINLAND,LIVERPOOL (JOHN LENNON),ENONTEKIO,370,0,370,360,0,360,2.777778
15/02/2023 17:21,202212,WESTERN EUROPE-EU,FINLAND,LIVERPOOL (JOHN LENNON),IVALO,436,0,436,383,0,383,13.83812
15/02/2023 17:21,202212,WESTERN EUROPE-EU,FINLAND,MANCHESTER,ENONTEKIO,4066,0,4066,3179,0,3179,27.901856
15/02/2023 17:21,202212,WESTERN EUROPE-EU,FINLAND,MANCHESTER,HELSINKI,6613,6613,0,4453,4453,0,48.506625
15/02/2023 17:21,202212,WESTERN EUROPE-EU,FINLAND,MANCHESTER,IVALO,9772,0,9772,9355,0,9355,4.457509
15/02/2023 17:21,202212,WESTERN EUROPE-EU,FINLAND,MANCHESTER,KITTILA,15318,0,15318,11632,0,11632,31.688446
15/02/2023 17:21,202212,WESTERN EUROPE-EU,FINLAND,MANCHESTER,KUUSAMO,7484,0,7484,5102,0,5102,46.687574
15/02/2023 17:21,202212,WESTERN EUROPE-EU,FINLAND,MANCHESTER,ROVANIEMI,8782,2853,5929,5778,0,5778,51.990308
15/02/2023 17:21,202212,WESTERN EUROPE-EU,FINLAND,NEWCASTLE,ENONTEKIO,1115,1115,0,364,364,0,206.318681
15/02/2023 17:21,202212,WESTERN EUROPE-EU,FINLAND,NEWCASTLE,IVALO,642,642,0,758,397,361,-15.30343
15/02/2023 17:21,202212,WESTERN EUROPE-EU,FINLAND,NEWCASTLE,KITTILA,376,376,0,324,324,0,16.049383
15/02/2023 17:21,202212,WESTERN EUROPE-EU,FINLAND,NEWCASTLE,ROVANIEMI,2414,2414,0,2397,2397,0,0.70922
15/02/2023 17:21,202212,WESTERN EUROPE-EU,FINLAND,NORWICH,ENONTEKIO,378,0,378,0,0,0,0
15/02/2023 17:21,202212,WESTERN EUROPE-EU,FINLAND,TEESSIDE INTERNATIONAL AIRPORT,ENONTEKIO,0,0,0,342,0,342,-100
15/02/2023 17:21,202212,WESTERN EUROPE-EU,FRANCE,GATWICK,BORDEAUX,19163,19163,0,3990,3990,0,380.275689
15/02/2023 17:21,202212,WESTERN EUROPE-EU,FRANCE,GATWICK,CHAMBERY,5706,0,5706,1102,0,1102,417.785844
15/02/2023 17:21,202212,WESTERN EUROPE-EU,FRANCE,GATWICK,GRENOBLE,8559,6624,1935,1641,1223,418,421.572212
15/02/2023 17:21,202212,WESTERN EUROPE-EU,FRANCE,GATWICK,LYON,26220,24023,2197,7224,6880,344,262.956811
15/02/2023 17:21,202212,WESTERN EUROPE-EU,FRANCE,GATWICK,LYON(BRON),0,0,0,8,0,8,-100
15/02/2023 17:21,202212,WESTERN EUROPE-EU,FRANCE,GATWICK,MARSEILLE,5532,5532,0,3462,3462,0,59.792028
15/02/2023 17:21,202212,WESTERN EUROPE-EU,FRANCE,GATWICK,MONTPELLIER,8651,8651,0,3851,3851,0,124.64295
15/02/2023 17:21,202212,WESTERN EUROPE-EU,FRANCE,GATWICK,NANTES,11928,11928,0,3679,3679,0,224.218538
15/02/2023 17:21,202212,WESTERN EUROPE-EU,FRANCE,GATWICK,NICE,23018,23018,0,6269,6269,0,267.171798
15/02/2023 17:21,202212,WESTERN EUROPE-EU,FRANCE,GATWICK,PARIS (CHARLES DE GAULLE),29004,29004,0,8428,8428,0,244.138586
15/02/2023 17:21,202212,WESTERN EUROPE-EU,FRANCE,GATWICK,PARIS (ORLY),21128,21128,0,697,697,0,2931.276901
15/02/2023 17:21,202212,WESTERN EUROPE-EU,FRANCE,GATWICK,PAU,0,0,0,92,0,92,-100
15/02/2023 17:21,202212,WESTERN EUROPE-EU,FRANCE,GATWICK,RENNES,2280,2280,0,0,0,0,0
15/02/2023 17:21,202212,WESTERN EUROPE-EU,FRANCE,GATWICK,TOULOUSE (BLAGNAC),11113,9295,1818,2653,2413,240,318.884282
15/02/2023 17:21,202212,WESTERN EUROPE-EU,FRANCE,HEATHROW,BORDEAUX,0,0,0,664,664,0,-100
15/02/2023 17:21,202212,WESTERN EUROPE-EU,FRANCE,HEATHROW,GRENOBLE,1708,844,864,1138,1138,0,50.087873
15/02/2023 17:21,202212,WESTERN EUROPE-EU,FRANCE,HEATHROW,LYON,17815,17026,789,8150,8150,0,118.588957
15/02/2023 17:21,202212,WESTERN EUROPE-EU,FRANCE,HEATHROW,MARSEILLE,12191,12191,0,4164,4164,0,192.771374
15/02/2023 17:21,202212,WESTERN EUROPE-EU,FRANCE,HEATHROW,NICE,39218,39218,0,16434,16434,0,138.639406
15/02/2023 17:21,202212,WESTERN EUROPE-EU,FRANCE,HEATHROW,PARIS (CHARLES DE GAULLE),94242,94242,0,38337,38337,0,145.825182
15/02/2023 17:21,202212,WESTERN EUROPE-EU,FRANCE,HEATHROW,TOULOUSE (BLAGNAC),15329,15329,0,4322,4322,0,254.673762
15/02/2023 17:21,202212,WESTERN EUROPE-EU,FRANCE,LONDON CITY,CHAMBERY,438,438,0,0,0,0,0
15/02/2023 17:21,202212,WESTERN EUROPE-EU,FRANCE,LUTON,BEZIERS,1920,1920,0,1142,1142,0,68.126095
15/02/2023 17:21,202212,WESTERN EUROPE-EU,FRANCE,LUTON,BORDEAUX,623,623,0,631,631,0,-1.267829
15/02/2023 17:21,202212,WESTERN EUROPE-EU,FRANCE,LUTON,GRENOBLE,4508,4508,0,1215,1215,0,271.028807
15/02/2023 17:21,202212,WESTERN EUROPE-EU,FRANCE,LUTON,LYON,11283,11283,0,2270,2270,0,397.048458
15/02/2023 17:21,202212,WESTERN EUROPE-EU,FRANCE,LUTON,MONTPELLIER,110,110,0,0,0,0,0
15/02/2023 17:21,202212,WESTERN EUROPE-EU,FRANCE,LUTON,NICE,611,611,0,733,733,0,-16.643929
15/02/2023 17:21,202212,WESTERN EUROPE-EU,FRANCE,LUTON,PARIS (CHARLES DE GAULLE),23624,23624,0,6109,6109,0,286.708136
15/02/2023 17:21,202212,WESTERN EUROPE-EU,FRANCE,STANSTED,BERGERAC,3006,3006,0,1063,1063,0,182.784572
15/02/2023 17:21,202212,WESTERN EUROPE-EU,FRANCE,STANSTED,BIARRITZ,2918,2918,0,2107,2107,0,38.490745
15/02/2023 17:21,202212,WESTERN EUROPE-EU,FRANCE,STANSTED,BORDEAUX,10568,10568,0,3726,3726,0,183.628556
15/02/2023 17:21,202212,WESTERN EUROPE-EU,FRANCE,STANSTED,CARCASSONNE,2513,2513,0,1138,1138,0,120.826011
15/02/2023 17:21,202212,WESTERN EUROPE-EU,FRANCE,STANSTED,CHAMBERY,1867,1506,361,193,0,193,867.357513
15/02/2023 17:21,202212,WESTERN EUROPE-EU,FRANCE,STANSTED,DOLE,0,0,0,93,93,0,-100
15/02/2023 17:21,202212,WESTERN EUROPE-EU,FRANCE,STANSTED,GRENOBLE,2913,2913,0,540,540,0,439.444444
15/02/2023 17:21,202212,WESTERN EUROPE-EU,FRANCE,STANSTED,LA ROCHELLE,0,0,0,867,867,0,-100
15/02/2023 17:21,202212,WESTERN EUROPE-EU,FRANCE,STANSTED,LIMOGES,2875,2875,0,2529,2529,0,13.681297
15/02/2023 17:21,202212,WESTERN EUROPE-EU,FRANCE,STANSTED,MARSEILLE,9833,9833,0,4023,4023,0,144.419587
15/02/2023 17:21,202212,WESTERN EUROPE-EU,FRANCE,STANSTED,NANTES,8796,8796,0,3800,3800,0,131.473684
15/02/2023 17:21,202212,WESTERN EUROPE-EU,FRANCE,STANSTED,NICE,0,0,0,1192,1192,0,-100
15/02/2023 17:21,202212,WESTERN EUROPE-EU,FRANCE,STANSTED,POITIERS,2976,2976,0,1051,1051,0,183.158896
15/02/2023 17:21,202212,WESTERN EUROPE-EU,FRANCE,STANSTED,TARBES-LOURDES INTERNATIONAL,2584,2584,0,907,907,0,184.895259
15/02/2023 17:21,202212,WESTERN EUROPE-EU,FRANCE,STANSTED,TOULOUSE (BLAGNAC),18246,18246,0,4136,4136,0,341.15087
15/02/2023 17:21,202212,WESTERN EUROPE-EU,FRANCE,STANSTED,TOURS,2558,2558,0,1003,1003,0,155.034895
15/02/2023 17:21,202212,WESTERN EUROPE-EU,FRANCE,BELFAST INTERNATIONAL,CLERMONT FERRAND,0,0,0,98,0,98,-100
15/02/2023 17:21,202212,WESTERN EUROPE-EU,FRANCE,BELFAST INTERNATIONAL,LA ROCHELLE,298,0,298,0,0,0,0
15/02/2023 17:21,202212,WESTERN EUROPE-EU,FRANCE,BELFAST INTERNATIONAL,LYON,1380,1380,0,646,646,0,113.622291
15/02/2023 17:21,202212,WESTERN EUROPE-EU,FRANCE,BELFAST INTERNATIONAL,PARIS (CHARLES DE GAULLE),6613,6613,0,1622,1622,0,307.706535
15/02/2023 17:21,202212,WESTERN EUROPE-EU,FRANCE,BELFAST INTERNATIONAL,PARIS (ORLY),0,0,0,100,100,0,-100
15/02/2023 17:21,202212,WESTERN EUROPE-EU,FRANCE,BIGGIN HILL,BEZIERS,0,0,0,2,0,2,-100
15/02/2023 17:21,202212,WESTERN EUROPE-EU,FRANCE,BIGGIN HILL,CHAMBERY,10,0,10,0,0,0,0
15/02/2023 17:21,202212,WESTERN EUROPE-EU,FRANCE,BIGGIN HILL,LYON,7,0,7,0,0,0,0
15/02/2023 17:21,202212,WESTERN EUROPE-EU,FRANCE,BIGGIN HILL,LYON(BRON),6,0,6,0,0,0,0
15/02/2023 17:21,202212,WESTERN EUROPE-EU,FRANCE,BIGGIN HILL,NICE,12,0,12,0,0,0,0
15/02/2023 17:21,202212,WESTERN EUROPE-EU,FRANCE,BIGGIN HILL,PARIS (LE BOURGET),8,0,8,14,0,14,-42.857143
15/02/2023 17:21,202212,WESTERN EUROPE-EU,FRANCE,BIRMINGHAM,BORDEAUX,2027,2027,0,0,0,0,0
15/02/2023 17:21,202212,WESTERN EUROPE-EU,FRANCE,BIRMINGHAM,CHAMBERY,2614,764,1850,243,0,243,975.720165
15/02/2023 17:21,202212,WESTERN EUROPE-EU,FRANCE,BIRMINGHAM,GRENOBLE,1465,1465,0,180,180,0,713.888889
15/02/2023 17:21,202212,WESTERN EUROPE-EU,FRANCE,BIRMINGHAM,LA ROCHELLE,307,0,307,0,0,0,0
15/02/2023 17:21,202212,WESTERN EUROPE-EU,FRANCE,BIRMINGHAM,PARIS (CHARLES DE GAULLE),20901,20901,0,9517,9517,0,119.617527
15/02/2023 17:21,202212,WESTERN EUROPE-EU,FRANCE,BIRMINGHAM,PARIS (ORLY),4678,4678,0,996,996,0,369.678715
15/02/2023 17:21,202212,WESTERN EUROPE-EU,FRANCE,BIRMINGHAM,TOULOUSE (BLAGNAC),3377,2816,561,0,0,0,0
15/02/2023 17:21,202212,WESTERN EUROPE-EU,FRANCE,BRISTOL,BORDEAUX,308,0,308,0,0,0,0
15/02/2023 17:21,202212,WESTERN EUROPE-EU,FRANCE,BRISTOL,CHAMBERY,1657,1096,561,422,311,111,292.654028
15/02/2023 17:21,202212,WESTERN EUROPE-EU,FRANCE,BRISTOL,GRENOBLE,3485,3117,368,1001,1001,0,248.151848
15/02/2023 17:21,202212,WESTERN EUROPE-EU,FRANCE,BRISTOL,LYON,1720,1720,0,985,985,0,74.619289
15/02/2023 17:21,202212,WESTERN EUROPE-EU,FRANCE,BRISTOL,NICE,2502,2502,0,414,414,0,504.347826
15/02/2023 17:21,202212,WESTERN EUROPE-EU,FRANCE,BRISTOL,PARIS (CHARLES DE GAULLE),14448,14448,0,3726,3726,0,287.761675
15/02/2023 17:21,202212,WESTERN EUROPE-EU,FRANCE,BRISTOL,PARIS (ORLY),10313,10313,0,3098,3098,0,232.892189
15/02/2023 17:21,202212,WESTERN EUROPE-EU,FRANCE,BRISTOL,PERPIGNAN,244,0,244,0,0,0,0
15/02/2023 17:21,202212,WESTERN EUROPE-EU,FRANCE,BRISTOL,TOULON / HYERES,246,0,246,0,0,0,0
15/02/2023 17:21,202212,WESTERN EUROPE-EU,FRANCE,BRISTOL,TOULOUSE (BLAGNAC),3978,3434,544,1782,1782,0,123.232323
15/02/2023 17:21,202212,WESTERN EUROPE-EU,FRANCE,CARDIFF WALES,BIARRITZ,39,0,39,0,0,0,0
15/02/2023 17:21,202212,WESTERN EUROPE-EU,FRANCE,CARDIFF WALES,BRIVE-LA-GAILLARDE,124,0,124,0,0,0,0
15/02/2023 17:21,202212,WESTERN EUROPE-EU,FRANCE,CARDIFF WALES,LYON,0,0,0,82,0,82,-100
15/02/2023 17:21,202212,WESTERN EUROPE-EU,FRANCE,CARDIFF WALES,PARIS (ORLY),0,0,0,273,273,0,-100
15/02/2023 17:21,202212,WESTERN EUROPE-EU,FRANCE,CARDIFF WALES,PAU,127,0,127,0,0,0,0
15/02/2023 17:21,202212,WESTERN EUROPE-EU,FRANCE,CARDIFF WALES,PERPIGNAN,0,0,0,86,0,86,-100
15/02/2023 17:21,202212,WESTERN EUROPE-EU,FRANCE,CARDIFF WALES,SAINT BRIEUC (ARMOR),0,0,0,48,0,48,-100
15/02/2023 17:21,202212,WESTERN EUROPE-EU,FRANCE,CARDIFF WALES,TOULOUSE (BLAGNAC),0,0,0,98,0,98,-100
15/02/2023 17:21,202212,WESTERN EUROPE-EU,FRANCE,EAST MIDLANDS INTERNATIONAL,CHAMBERY,545,0,545,0,0,0,0
15/02/2023 17:21,202212,WESTERN EUROPE-EU,FRANCE,EAST MIDLANDS INTERNATIONAL,CLERMONT FERRAND,85,0,85,0,0,0,0
15/02/2023 17:21,202212,WESTERN EUROPE-EU,FRANCE,EAST MIDLANDS INTERNATIONAL,LIMOGES,1676,1676,0,931,931,0,80.021482
15/02/2023 17:21,202212,WESTERN EUROPE-EU,FRANCE,EDINBURGH,BEAUVAIS,8819,8819,0,1097,1097,0,703.919781
15/02/2023 17:21,202212,WESTERN EUROPE-EU,FRANCE,EDINBURGH,CHAMBERY,1087,169,918,64,0,64,1598.4375
15/02/2023 17:21,202212,WESTERN EUROPE-EU,FRANCE,EDINBURGH,GRENOBLE,1526,1526,0,171,171,0,792.397661
15/02/2023 17:21,202212,WESTERN EUROPE-EU,FRANCE,EDINBURGH,LYON,488,488,0,657,657,0,-25.722983
15/02/2023 17:21,202212,WESTERN EUROPE-EU,FRANCE,EDINBURGH,MARSEILLE,2676,2676,0,1150,1150,0,132.695652
15/02/2023 17:21,202212,WESTERN EUROPE-EU,FRANCE,EDINBURGH,NANTES,2740,2740,0,1028,1028,0,166.536965
15/02/2023 17:21,202212,WESTERN EUROPE-EU,FRANCE,EDINBURGH,PARIS (CHARLES DE GAULLE),28956,28956,0,10093,10093,0,186.891905
15/02/2023 17:21,202212,WESTERN EUROPE-EU,FRANCE,EDINBURGH,PARIS (ORLY),0,0,0,516,516,0,-100
15/02/2023 17:21,202212,WESTERN EUROPE-EU,FRANCE,EDINBURGH,TOULOUSE (BLAGNAC),2862,2688,174,1188,1188,0,140.909091
15/02/2023 17:21,202212,WESTERN EUROPE-EU,FRANCE,EXETER,CHAMBERY,559,0,559,0,0,0,0
15/02/2023 17:21,202212,WESTERN EUROPE-EU,FRANCE,EXETER,MONTPELLIER,0,0,0,46,0,46,-100
15/02/2023 17:21,202212,WESTERN EUROPE-EU,FRANCE,GLASGOW,CHAMBERY,189,0,189,0,0,0,0
15/02/2023 17:21,202212,WESTERN EUROPE-EU,FRANCE,GLASGOW,LA ROCHELLE,0,0,0,94,0,94,-100
15/02/2023 17:21,202212,WESTERN EUROPE-EU,FRANCE,GLASGOW,LYON,0,0,0,453,0,453,-100
15/02/2023 17:21,202212,WESTERN EUROPE-EU,FRANCE,GLASGOW,PARIS (CHARLES DE GAULLE),7671,7671,0,1849,1849,0,314.872904
15/02/2023 17:21,202212,WESTERN EUROPE-EU,FRANCE,GLASGOW,PARIS (ORLY),0,0,0,437,437,0,-100
15/02/2023 17:21,202212,WESTERN EUROPE-EU,FRANCE,GLASGOW,PERPIGNAN,97,0,97,0,0,0,0
15/02/2023 17:21,202212,WESTERN EUROPE-EU,FRANCE,GUERNSEY,TOULOUSE (BLAGNAC),1,1,0,0,0,0,0
15/02/2023 17:21,202212,WESTERN EUROPE-EU,FRANCE,JERSEY,RENNES,0,0,0,41,0,41,-100
15/02/2023 17:21,202212,WESTERN EUROPE-EU,FRANCE,LEEDS BRADFORD,CHAMBERY,693,693,0,0,0,0,0
15/02/2023 17:21,202212,WESTERN EUROPE-EU,FRANCE,LEEDS BRADFORD,NICE,66,0,66,0,0,0,0
15/02/2023 17:21,202212,WESTERN EUROPE-EU,FRANCE,LEEDS BRADFORD,PARIS (CHARLES DE GAULLE),4452,4452,0,790,790,0,463.544304
15/02/2023 17:21,202212,WESTERN EUROPE-EU,FRANCE,LIVERPOOL (JOHN LENNON),BEAUVAIS,2415,2415,0,508,508,0,375.393701
15/02/2023 17:21,202212,WESTERN EUROPE-EU,FRANCE,LIVERPOOL (JOHN LENNON),GRENOBLE,555,555,0,274,274,0,102.554745
15/02/2023 17:21,202212,WESTERN EUROPE-EU,FRANCE,LIVERPOOL (JOHN LENNON),PARIS (CHARLES DE GAULLE),4641,4641,0,0,0,0,0
15/02/2023 17:21,202212,WESTERN EUROPE-EU,FRANCE,MANCHESTER,BEAUVAIS,4979,4979,0,2106,2106,0,136.419753
15/02/2023 17:21,202212,WESTERN EUROPE-EU,FRANCE,MANCHESTER,BORDEAUX,5310,5310,0,1370,1370,0,287.591241
15/02/2023 17:21,202212,WESTERN EUROPE-EU,FRANCE,MANCHESTER,CARCASSONNE,2930,2930,0,1388,1388,0,111.095101
15/02/2023 17:21,202212,WESTERN EUROPE-EU,FRANCE,MANCHESTER,CHAMBERY,4178,1768,2410,503,270,233,730.616302
15/02/2023 17:21,202212,WESTERN EUROPE-EU,FRANCE,MANCHESTER,GRENOBLE,2197,2197,0,451,451,0,387.13969
15/02/2023 17:21,202212,WESTERN EUROPE-EU,FRANCE,MANCHESTER,LILLE,106,106,0,0,0,0,0
15/02/2023 17:21,202212,WESTERN EUROPE-EU,FRANCE,MANCHESTER,LIMOGES,2224,2224,0,1193,1193,0,86.420788
15/02/2023 17:21,202212,WESTERN EUROPE-EU,FRANCE,MANCHESTER,LYON,1771,1771,0,840,840,0,110.833333
15/02/2023 17:21,202212,WESTERN EUROPE-EU,FRANCE,MANCHESTER,MARSEILLE,2140,2140,0,1130,1130,0,89.380531
15/02/2023 17:21,202212,WESTERN EUROPE-EU,FRANCE,MANCHESTER,NANTES,2261,2261,0,1266,1266,0,78.593997
15/02/2023 17:21,202212,WESTERN EUROPE-EU,FRANCE,MANCHESTER,NICE,2418,2418,0,0,0,0,0
15/02/2023 17:21,202212,WESTERN EUROPE-EU,FRANCE,MANCHESTER,PARIS (CHARLES DE GAULLE),56120,56120,0,23474,23474,0,139.073017
15/02/2023 17:21,202212,WESTERN EUROPE-EU,FRANCE,MANCHESTER,TOULOUSE (BLAGNAC),1047,0,1047,0,0,0,0
15/02/2023 17:21,202212,WESTERN EUROPE-EU,FRANCE,NEWCASTLE,GRENOBLE,948,948,0,0,0,0,0
15/02/2023 17:21,202212,WESTERN EUROPE-EU,FRANCE,NEWCASTLE,PARIS (CHARLES DE GAULLE),8116,8116,0,3707,3707,0,118.937146
15/02/2023 17:21,202212,WESTERN EUROPE-EU,FRANCE,NEWCASTLE,PARIS (ORLY),0,0,0,382,382,0,-100
15/02/2023 17:21,202212,WESTERN EUROPE-EU,FRANCE,SOUTHAMPTON,CHAMBERY,323,323,0,0,0,0,0
15/02/2023 17:21,202212,WESTERN EUROPE-EU,GERMANY,GATWICK,BERLIN BRANDENBURG,24365,24365,0,7845,7845,0,210.579987
15/02/2023 17:21,202212,WESTERN EUROPE-EU,GERMANY,GATWICK,BRAUNSCHWEIG,0,0,0,83,0,83,-100
15/02/2023 17:21,202212,WESTERN EUROPE-EU,GERMANY,GATWICK,FRIEDRICHSHAFEN,705,705,0,161,161,0,337.888199
15/02/2023 17:21,202212,WESTERN EUROPE-EU,GERMANY,GATWICK,HAMBURG,5711,5711,0,2710,2710,0,110.738007
15/02/2023 17:21,202212,WESTERN EUROPE-EU,GERMANY,GATWICK,MUNICH,17239,17239,0,4115,4115,0,318.930741
15/02/2023 17:21,202212,WESTERN EUROPE-EU,GERMANY,HEATHROW,BERLIN BRANDENBURG,42049,42049,0,13291,13291,0,216.371981
15/02/2023 17:21,202212,WESTERN EUROPE-EU,GERMANY,HEATHROW,COLOGNE BONN,16200,16200,0,2424,2424,0,568.316832
15/02/2023 17:21,202212,WESTERN EUROPE-EU,GERMANY,HEATHROW,DUSSELDORF,47910,47910,0,10997,10997,0,335.664272
15/02/2023 17:21,202212,WESTERN EUROPE-EU,GERMANY,HEATHROW,FRANKFURT MAIN,114847,114847,0,36122,36122,0,217.941974
15/02/2023 17:21,202212,WESTERN EUROPE-EU,GERMANY,HEATHROW,HAMBURG,44199,44199,0,9400,9400,0,370.202128
15/02/2023 17:21,202212,WESTERN EUROPE-EU,GERMANY,HEATHROW,HANOVER,10374,10374,0,1777,1777,0,483.792909
15/02/2023 17:21,202212,WESTERN EUROPE-EU,GERMANY,HEATHROW,MUNICH,99700,99700,0,23669,23669,0,321.226076
15/02/2023 17:21,202212,WESTERN EUROPE-EU,GERMANY,HEATHROW,NUREMBERG,4822,4822,0,0,0,0,0
15/02/2023 17:21,202212,WESTERN EUROPE-EU,GERMANY,HEATHROW,STUTTGART,30813,30813,0,4742,4742,0,549.789119
15/02/2023 17:21,202212,WESTERN EUROPE-EU,GERMANY,LONDON CITY,BERLIN BRANDENBURG,14919,14919,0,3874,3874,0,285.105834
15/02/2023 17:21,202212,WESTERN EUROPE-EU,GERMANY,LONDON CITY,DUSSELDORF,12208,12208,0,2093,2093,0,483.277592
15/02/2023 17:21,202212,WESTERN EUROPE-EU,GERMANY,LONDON CITY,FRANKFURT MAIN,20699,20699,0,4614,4614,0,348.612917
15/02/2023 17:21,202212,WESTERN EUROPE-EU,GERMANY,LUTON,BERLIN BRANDENBURG,7762,7762,0,2051,2051,0,278.449537
15/02/2023 17:21,202212,WESTERN EUROPE-EU,GERMANY,LUTON,STUTTGART,0,0,0,97,97,0,-100
15/02/2023 17:21,202212,WESTERN EUROPE-EU,GERMANY,STANSTED,BERLIN BRANDENBURG,32145,32145,0,11764,11764,0,173.248895
15/02/2023 17:21,202212,WESTERN EUROPE-EU,GERMANY,STANSTED,BREMEN,14651,14651,0,3056,3056,0,379.417539
15/02/2023 17:21,202212,WESTERN EUROPE-EU,GERMANY,STANSTED,COLOGNE BONN,21681,21681,0,5870,5870,0,269.352641
15/02/2023 17:21,202212,WESTERN EUROPE-EU,GERMANY,STANSTED,DORTMUND,4737,4737,0,2208,2208,0,114.538043
15/02/2023 17:21,202212,WESTERN EUROPE-EU,GERMANY,STANSTED,DRESDEN,3955,3955,0,949,949,0,316.754478
15/02/2023 17:21,202212,WESTERN EUROPE-EU,GERMANY,STANSTED,FRANKFURT MAIN,0,0,0,8197,8197,0,-100
15/02/2023 17:21,202212,WESTERN EUROPE-EU,GERMANY,STANSTED,HAHN,8687,8687,0,0,0,0,0
15/02/2023 17:21,202212,WESTERN EUROPE-EU,GERMANY,STANSTED,HAMBURG,10744,10744,0,3858,3858,0,178.486262
15/02/2023 17:21,202212,WESTERN EUROPE-EU,GERMANY,STANSTED,KARLSRUHE/BADEN BADEN,9202,9202,0,3352,3352,0,174.522673
15/02/2023 17:21,202212,WESTERN EUROPE-EU,GERMANY,STANSTED,LEIPZIG,4030,4030,0,0,0,0,0
15/02/2023 17:21,202212,WESTERN EUROPE-EU,GERMANY,STANSTED,MEMMINGEN ALLGAU,8195,8195,0,1948,1948,0,320.687885
15/02/2023 17:21,202212,WESTERN EUROPE-EU,GERMANY,STANSTED,NUREMBERG,14422,14422,0,1597,1597,0,803.068253
15/02/2023 17:21,202212,WESTERN EUROPE-EU,GERMANY,BIGGIN HILL,DORTMUND,0,0,0,4,0,4,-100
15/02/2023 17:21,202212,WESTERN EUROPE-EU,GERMANY,BIGGIN HILL,DUSSELDORF,0,0,0,4,0,4,-100
15/02/2023 17:21,202212,WESTERN EUROPE-EU,GERMANY,BIGGIN HILL,FRANKFURT MAIN,11,0,11,5,0,5,120
15/02/2023 17:21,202212,WESTERN EUROPE-EU,GERMANY,BIGGIN HILL,STUTTGART,5,0,5,0,0,0,0
15/02/2023 17:21,202212,WESTERN EUROPE-EU,GERMANY,BIRMINGHAM,BERLIN BRANDENBURG,1399,1399,0,572,572,0,144.58042
15/02/2023 17:21,202212,WESTERN EUROPE-EU,GERMANY,BIRMINGHAM,DUSSELDORF,8755,8755,0,1911,1911,0,358.137101
15/02/2023 17:21,202212,WESTERN EUROPE-EU,GERMANY,BIRMINGHAM,FRANKFURT MAIN,19278,19278,0,5749,5749,0,235.327883
15/02/2023 17:21,202212,WESTERN EUROPE-EU,GERMANY,BIRMINGHAM,MUNICH,17713,17713,0,3475,3475,0,409.726619
15/02/2023 17:21,202212,WESTERN EUROPE-EU,GERMANY,BRISTOL,BERLIN BRANDENBURG,3327,3327,0,1441,1441,0,130.881332
15/02/2023 17:21,202212,WESTERN EUROPE-EU,GERMANY,BRISTOL,COLOGNE BONN,3873,3873,0,966,966,0,300.931677
15/02/2023 17:21,202212,WESTERN EUROPE-EU,GERMANY,BRISTOL,FRANKFURT MAIN,3475,3475,0,1753,1753,0,98.231603
15/02/2023 17:21,202212,WESTERN EUROPE-EU,GERMANY,EAST MIDLANDS INTERNATIONAL,BERLIN BRANDENBURG,3510,3510,0,996,996,0,252.409639
15/02/2023 17:21,202212,WESTERN EUROPE-EU,GERMANY,EAST MIDLANDS INTERNATIONAL,FRANKFURT MAIN,58,58,0,0,0,0,0
15/02/2023 17:21,202212,WESTERN EUROPE-EU,GERMANY,EAST MIDLANDS INTERNATIONAL,MUNICH,101,101,0,0,0,0,0
15/02/2023 17:21,202212,WESTERN EUROPE-EU,GERMANY,EDINBURGH,BERLIN BRANDENBURG,11385,11385,0,3447,3447,0,230.287206
15/02/2023 17:21,202212,WESTERN EUROPE-EU,GERMANY,EDINBURGH,DUSSELDORF,2563,2563,0,967,967,0,165.046536
15/02/2023 17:21,202212,WESTERN EUROPE-EU,GERMANY,EDINBURGH,FRANKFURT MAIN,14884,14884,0,5043,5043,0,195.141781
15/02/2023 17:21,202212,WESTERN EUROPE-EU,GERMANY,EDINBURGH,HAMBURG,5256,5256,0,1037,1037,0,406.846673
15/02/2023 17:21,202212,WESTERN EUROPE-EU,GERMANY,EDINBURGH,MUNICH,3771,3771,0,671,671,0,461.997019
15/02/2023 17:21,202212,WESTERN EUROPE-EU,GERMANY,EDINBURGH,NIEDERRHEIN,4416,4416,0,0,0,0,0
15/02/2023 17:21,202212,WESTERN EUROPE-EU,GERMANY,GLASGOW,BERLIN BRANDENBURG,3894,3894,0,0,0,0,0
15/02/2023 17:21,202212,WESTERN EUROPE-EU,GERMANY,GLASGOW,FRANKFURT MAIN,9935,9935,0,3744,3744,0,165.357906
15/02/2023 17:21,202212,WESTERN EUROPE-EU,GERMANY,LEEDS BRADFORD,BERLIN BRANDENBURG,968,968,0,375,375,0,158.133333
15/02/2023 17:21,202212,WESTERN EUROPE-EU,GERMANY,LEEDS BRADFORD,COLOGNE BONN,428,428,0,130,130,0,229.230769
15/02/2023 17:21,202212,WESTERN EUROPE-EU,GERMANY,LIVERPOOL (JOHN LENNON),FRANKFURT MAIN,1128,1128,0,0,0,0,0
15/02/2023 17:21,202212,WESTERN EUROPE-EU,GERMANY,MANCHESTER,BERLIN BRANDENBURG,20706,20706,0,7888,7888,0,162.5
15/02/2023 17:21,202212,WESTERN EUROPE-EU,GERMANY,MANCHESTER,COLOGNE BONN,12219,12219,0,3935,3935,0,210.520966
15/02/2023 17:21,202212,WESTERN EUROPE-EU,GERMANY,MANCHESTER,DUSSELDORF,8239,8239,0,2109,2109,0,290.65908
15/02/2023 17:21,202212,WESTERN EUROPE-EU,GERMANY,MANCHESTER,FRANKFURT MAIN,32179,32179,0,11061,11061,0,190.923063
15/02/2023 17:21,202212,WESTERN EUROPE-EU,GERMANY,MANCHESTER,HAMBURG,6803,6803,0,2965,2965,0,129.443508
15/02/2023 17:21,202212,WESTERN EUROPE-EU,GERMANY,MANCHESTER,LEIPZIG,0,0,0,169,0,169,-100
15/02/2023 17:21,202212,WESTERN EUROPE-EU,GERMANY,MANCHESTER,MUNICH,23950,23950,0,5295,5295,0,352.313503
15/02/2023 17:21,202212,WESTERN EUROPE-EU,GERMANY,NEWCASTLE,BERLIN BRANDENBURG,1221,1221,0,496,496,0,146.169355
15/02/2023 17:21,202212,WESTERN EUROPE-EU,GERMANY,NEWCASTLE,COLOGNE BONN,632,632,0,141,141,0,348.22695
15/02/2023 17:21,202212,WESTERN EUROPE-EU,GERMANY,NEWCASTLE,DUSSELDORF,2162,2162,0,432,432,0,400.462963
15/02/2023 17:21,202212,WESTERN EUROPE-EU,GERMANY,NEWCASTLE,FRANKFURT MAIN,3557,3557,0,1584,1584,0,124.558081
15/02/2023 17:21,202212,WESTERN EUROPE-EU,GIBRALTAR,GATWICK,GIBRALTAR,8453,8453,0,4965,4965,0,70.251762
15/02/2023 17:21,202212,WESTERN EUROPE-EU,GIBRALTAR,HEATHROW,GIBRALTAR,7771,7771,0,7602,7602,0,2.223099
15/02/2023 17:21,202212,WESTERN EUROPE-EU,GIBRALTAR,LUTON,GIBRALTAR,0,0,0,1534,1534,0,-100
15/02/2023 17:21,202212,WESTERN EUROPE-EU,GIBRALTAR,BRISTOL,GIBRALTAR,1540,1540,0,1986,1986,0,-22.4572
15/02/2023 17:21,202212,WESTERN EUROPE-EU,GIBRALTAR,EDINBURGH,GIBRALTAR,2230,2230,0,1167,1167,0,91.08826
15/02/2023 17:21,202212,WESTERN EUROPE-EU,GIBRALTAR,MANCHESTER,GIBRALTAR,3564,3564,0,2366,2366,0,50.633981
15/02/2023 17:21,202212,WESTERN EUROPE-EU,GREECE,GATWICK,ATHENS,25303,25303,0,10842,10842,0,133.37945
15/02/2023 17:21,202212,WESTERN EUROPE-EU,GREECE,GATWICK,SALONIKA,7319,7319,0,4160,4160,0,75.9375
15/02/2023 17:21,202212,WESTERN EUROPE-EU,GREECE,HEATHROW,ATHENS,53501,53501,0,36156,36156,0,47.972674
15/02/2023 17:21,202212,WESTERN EUROPE-EU,GREECE,LUTON,ATHENS,12053,12053,0,4391,4391,0,174.493282
15/02/2023 17:21,202212,WESTERN EUROPE-EU,GREECE,LUTON,SALONIKA,4302,4302,0,2160,2160,0,99.166667
15/02/2023 17:21,202212,WESTERN EUROPE-EU,GREECE,STANSTED,ATHENS,11494,11494,0,7904,7904,0,45.42004
15/02/2023 17:21,202212,WESTERN EUROPE-EU,GREECE,STANSTED,SALONIKA,8485,8485,0,5812,5812,0,45.991053
15/02/2023 17:21,202212,WESTERN EUROPE-EU,GREECE,BIGGIN HILL,ATHENS,0,0,0,2,0,2,-100
15/02/2023 17:21,202212,WESTERN EUROPE-EU,GREECE,BRISTOL,ATHENS,2598,2598,0,0,0,0,0
15/02/2023 17:21,202212,WESTERN EUROPE-EU,GREECE,EAST MIDLANDS INTERNATIONAL,ATHENS,109,0,109,0,0,0,0
15/02/2023 17:21,202212,WESTERN EUROPE-EU,GREECE,EDINBURGH,ATHENS,3296,3296,0,1260,1260,0,161.587302
15/02/2023 17:21,202212,WESTERN EUROPE-EU,GREECE,MANCHESTER,ATHENS,8076,8076,0,5381,5381,0,50.083628
15/02/2023 17:21,202212,WESTERN EUROPE-EU,GREECE,MANCHESTER,SALONIKA,0,0,0,1869,1869,0,-100
15/02/2023 17:21,202212,WESTERN EUROPE-EU,IRISH REPUBLIC,GATWICK,CORK,9473,9473,0,6126,6126,0,54.635978
15/02/2023 17:21,202212,WESTERN EUROPE-EU,IRISH REPUBLIC,GATWICK,DUBLIN,107286,107286,0,58972,58972,0,81.927016
15/02/2023 17:21,202212,WESTERN EUROPE-EU,IRISH REPUBLIC,GATWICK,IRELAND WEST(KNOCK),6083,6083,0,2115,2115,0,187.612293
15/02/2023 17:21,202212,WESTERN EUROPE-EU,IRISH REPUBLIC,GATWICK,SHANNON,9018,9018,0,7006,7006,0,28.718242
15/02/2023 17:21,202212,WESTERN EUROPE-EU,IRISH REPUBLIC,HEATHROW,CORK,25683,25683,0,11501,11501,0,123.311016
15/02/2023 17:21,202212,WESTERN EUROPE-EU,IRISH REPUBLIC,HEATHROW,DUBLIN,119862,119862,0,59435,59393,42,101.66905
15/02/2023 17:21,202212,WESTERN EUROPE-EU,IRISH REPUBLIC,HEATHROW,SHANNON,18811,18811,0,4583,4583,0,310.451669
15/02/2023 17:21,202212,WESTERN EUROPE-EU,IRISH REPUBLIC,LONDON CITY,DUBLIN,17025,17025,0,10284,10284,0,65.548425
15/02/2023 17:21,202212,WESTERN EUROPE-EU,IRISH REPUBLIC,LUTON,CORK,7267,7267,0,3888,3888,0,86.908436
15/02/2023 17:21,202212,WESTERN EUROPE-EU,IRISH REPUBLIC,LUTON,DUBLIN,25471,25471,0,15528,15528,0,64.032715
15/02/2023 17:21,202212,WESTERN EUROPE-EU,IRISH REPUBLIC,LUTON,IRELAND WEST(KNOCK),6681,6681,0,5283,5283,0,26.462237
15/02/2023 17:21,202212,WESTERN EUROPE-EU,IRISH REPUBLIC,LUTON,KERRY COUNTY,9081,9081,0,4267,4267,0,112.819311
15/02/2023 17:21,202212,WESTERN EUROPE-EU,IRISH REPUBLIC,LUTON,SHANNON,0,0,0,2579,2579,0,-100
15/02/2023 17:21,202212,WESTERN EUROPE-EU,IRISH REPUBLIC,STANSTED,CORK,23506,23506,0,13281,13281,0,76.989685
15/02/2023 17:21,202212,WESTERN EUROPE-EU,IRISH REPUBLIC,STANSTED,DUBLIN,70990,70990,0,37268,37268,0,90.485135
15/02/2023 17:21,202212,WESTERN EUROPE-EU,IRISH REPUBLIC,STANSTED,IRELAND WEST(KNOCK),11722,11722,0,7127,7127,0,64.47313
15/02/2023 17:21,202212,WESTERN EUROPE-EU,IRISH REPUBLIC,STANSTED,KERRY COUNTY,6450,6450,0,3649,3649,0,76.760756
15/02/2023 17:21,202212,WESTERN EUROPE-EU,IRISH REPUBLIC,STANSTED,SHANNON,18360,18360,0,6605,6605,0,177.971234
15/02/2023 17:21,202212,WESTERN EUROPE-EU,IRISH REPUBLIC,ABERDEEN,DUBLIN,4217,4217,0,885,885,0,376.497175
15/02/2023 17:21,202212,WESTERN EUROPE-EU,IRISH REPUBLIC,BIGGIN HILL,DUBLIN,11,0,11,0,0,0,0
15/02/2023 17:21,202212,WESTERN EUROPE-EU,IRISH REPUBLIC,BIGGIN HILL,IRELAND WEST(KNOCK),0,0,0,13,0,13,-100
15/02/2023 17:21,202212,WESTERN EUROPE-EU,IRISH REPUBLIC,BIRMINGHAM,CORK,4868,4868,0,1898,1898,0,156.480506
15/02/2023 17:21,202212,WESTERN EUROPE-EU,IRISH REPUBLIC,BIRMINGHAM,DUBLIN,67114,67114,0,29284,29284,0,129.183172
15/02/2023 17:21,202212,WESTERN EUROPE-EU,IRISH REPUBLIC,BIRMINGHAM,IRELAND WEST(KNOCK),2107,2107,0,0,0,0,0
15/02/2023 17:21,202212,WESTERN EUROPE-EU,IRISH REPUBLIC,BIRMINGHAM,SHANNON,4786,4628,158,1508,1359,149,217.374005
15/02/2023 17:21,202212,WESTERN EUROPE-EU,IRISH REPUBLIC,BOURNEMOUTH,DUBLIN,2295,2295,0,1689,1689,0,35.879218
15/02/2023 17:21,202212,WESTERN EUROPE-EU,IRISH REPUBLIC,BRISTOL,DUBLIN,29234,29234,0,16228,16124,104,80.145428
15/02/2023 17:21,202212,WESTERN EUROPE-EU,IRISH REPUBLIC,BRISTOL,IRELAND WEST(KNOCK),1778,1778,0,1305,1305,0,36.245211
15/02/2023 17:21,202212,WESTERN EUROPE-EU,IRISH REPUBLIC,CARDIFF WALES,DUBLIN,4166,4106,60,2693,2693,0,54.697364
15/02/2023 17:21,202212,WESTERN EUROPE-EU,IRISH REPUBLIC,EAST MIDLANDS INTERNATIONAL,DUBLIN,12353,12353,0,4551,4551,0,171.434849
15/02/2023 17:21,202212,WESTERN EUROPE-EU,IRISH REPUBLIC,EAST MIDLANDS INTERNATIONAL,IRELAND WEST(KNOCK),4189,4189,0,2372,2372,0,76.602024
15/02/2023 17:21,202212,WESTERN EUROPE-EU,IRISH REPUBLIC,EDINBURGH,CORK,15845,15845,0,2494,2494,0,535.324779
15/02/2023 17:21,202212,WESTERN EUROPE-EU,IRISH REPUBLIC,EDINBURGH,DUBLIN,54437,54437,0,25025,25025,0,117.53047
15/02/2023 17:21,202212,WESTERN EUROPE-EU,IRISH REPUBLIC,EDINBURGH,IRELAND WEST(KNOCK),3730,3730,0,1411,1411,0,164.351524
15/02/2023 17:21,202212,WESTERN EUROPE-EU,IRISH REPUBLIC,EDINBURGH,SHANNON,4726,4680,46,1471,1471,0,221.278042
15/02/2023 17:21,202212,WESTERN EUROPE-EU,IRISH REPUBLIC,EXETER,DUBLIN,2436,2436,0,0,0,0,0
15/02/2023 17:21,202212,WESTERN EUROPE-EU,IRISH REPUBLIC,GLASGOW,DUBLIN,33874,33745,129,16877,16877,0,100.711027
15/02/2023 17:21,202212,WESTERN EUROPE-EU,IRISH REPUBLIC,GUERNSEY,DUBLIN,231,231,0,0,0,0,0
15/02/2023 17:21,202212,WESTERN EUROPE-EU,IRISH REPUBLIC,INVERNESS,DUBLIN,386,386,0,0,0,0,0
15/02/2023 17:21,202212,WESTERN EUROPE-EU,IRISH REPUBLIC,ISLE OF MAN,DUBLIN,2299,2299,0,0,0,0,0
15/02/2023 17:21,202212,WESTERN EUROPE-EU,IRISH REPUBLIC,LEEDS BRADFORD,DUBLIN,21856,21720,136,6858,6858,0,218.693497
15/02/2023 17:21,202212,WESTERN EUROPE-EU,IRISH REPUBLIC,LIVERPOOL (JOHN LENNON),CORK,6016,6016,0,3975,3975,0,51.345912
15/02/2023 17:21,202212,WESTERN EUROPE-EU,IRISH REPUBLIC,LIVERPOOL (JOHN LENNON),DUBLIN,28902,28902,0,10794,10794,0,167.759867
15/02/2023 17:21,202212,WESTERN EUROPE-EU,IRISH REPUBLIC,LIVERPOOL (JOHN LENNON),IRELAND WEST(KNOCK),7032,7032,0,3980,3980,0,76.683417
15/02/2023 17:21,202212,WESTERN EUROPE-EU,IRISH REPUBLIC,MANCHESTER,CORK,14177,14177,0,2508,2508,0,465.271132
15/02/2023 17:21,202212,WESTERN EUROPE-EU,IRISH REPUBLIC,MANCHESTER,DUBLIN,77593,77593,0,40833,40833,0,90.025225
15/02/2023 17:21,202212,WESTERN EUROPE-EU,IRISH REPUBLIC,MANCHESTER,IRELAND WEST(KNOCK),2399,2399,0,1566,1566,0,53.192848
15/02/2023 17:21,202212,WESTERN EUROPE-EU,IRISH REPUBLIC,MANCHESTER,KERRY COUNTY,1828,1828,0,1419,1419,0,28.823115
15/02/2023 17:21,202212,WESTERN EUROPE-EU,IRISH REPUBLIC,MANCHESTER,SHANNON,4203,4203,0,3895,3895,0,7.907574
15/02/2023 17:21,202212,WESTERN EUROPE-EU,IRISH REPUBLIC,NEWCASTLE,CORK,1894,1894,0,0,0,0,0
15/02/2023 17:21,202212,WESTERN EUROPE-EU,IRISH REPUBLIC,NEWCASTLE,DUBLIN,16299,16299,0,6003,6003,0,171.514243
15/02/2023 17:21,202212,WESTERN EUROPE-EU,IRISH REPUBLIC,NEWCASTLE,SHANNON,39,0,39,0,0,0,0
15/02/2023 17:21,202212,WESTERN EUROPE-EU,IRISH REPUBLIC,NEWQUAY,DUBLIN,2055,2055,0,0,0,0,0
15/02/2023 17:21,202212,WESTERN EUROPE-EU,IRISH REPUBLIC,PRESTWICK,DUBLIN,459,337,122,0,0,0,0
15/02/2023 17:21,202212,WESTERN EUROPE-EU,IRISH REPUBLIC,SOUTHAMPTON,DUBLIN,4719,4719,0,1115,1115,0,323.2287
15/02/2023 17:21,202212,WESTERN EUROPE-EU,IRISH REPUBLIC,TEESSIDE INTERNATIONAL AIRPORT,DUBLIN,61,61,0,0,0,0,0
15/02/2023 17:21,202212,WESTERN EUROPE-EU,ITALY,GATWICK,BARI (PALESE),3723,3723,0,0,0,0,0
15/02/2023 17:21,202212,WESTERN EUROPE-EU,ITALY,GATWICK,BERGAMO,3074,3074,0,1203,1203,0,155.527847
15/02/2023 17:21,202212,WESTERN EUROPE-EU,ITALY,GATWICK,BOLOGNA,0,0,0,71,71,0,-100
15/02/2023 17:21,202212,WESTERN EUROPE-EU,ITALY,GATWICK,CATANIA (FONTANAROSSA),9740,9740,0,3773,3773,0,158.150013
15/02/2023 17:21,202212,WESTERN EUROPE-EU,ITALY,GATWICK,FLORENCE,10277,10277,0,2795,2795,0,267.692308
15/02/2023 17:21,202212,WESTERN EUROPE-EU,ITALY,GATWICK,MILAN (LINATE),6239,6239,0,9050,9050,0,-31.060773
15/02/2023 17:21,202212,WESTERN EUROPE-EU,ITALY,GATWICK,MILAN (MALPENSA),54849,54849,0,12469,12469,0,339.88291
15/02/2023 17:21,202212,WESTERN EUROPE-EU,ITALY,GATWICK,NAPLES,18600,18600,0,4955,4955,0,275.378406
15/02/2023 17:21,202212,WESTERN EUROPE-EU,ITALY,GATWICK,PISA,8785,8785,0,4546,4546,0,93.24681
15/02/2023 17:21,202212,WESTERN EUROPE-EU,ITALY,GATWICK,ROME (FIUMICINO),48748,48748,0,8463,8463,0,476.013234
15/02/2023 17:21,202212,WESTERN EUROPE-EU,ITALY,GATWICK,TURIN,20107,18073,2034,3857,2350,1507,421.3119
15/02/2023 17:21,202212,WESTERN EUROPE-EU,ITALY,GATWICK,VENICE,21715,21715,0,5431,5431,0,299.834285
15/02/2023 17:21,202212,WESTERN EUROPE-EU,ITALY,GATWICK,VERONA VILLAFRANCA,14307,13410,897,3972,3467,505,260.196375
15/02/2023 17:21,202212,WESTERN EUROPE-EU,ITALY,HEATHROW,BERGAMO,914,914,0,0,0,0,0
15/02/2023 17:21,202212,WESTERN EUROPE-EU,ITALY,HEATHROW,BOLOGNA,15624,15624,0,5794,5794,0,169.658267
15/02/2023 17:21,202212,WESTERN EUROPE-EU,ITALY,HEATHROW,FLORENCE,346,346,0,0,0,0,0
15/02/2023 17:21,202212,WESTERN EUROPE-EU,ITALY,HEATHROW,MILAN (LINATE),44383,44383,0,26959,26959,0,64.631477
15/02/2023 17:21,202212,WESTERN EUROPE-EU,ITALY,HEATHROW,MILAN (MALPENSA),15844,15844,0,5111,5111,0,209.998043
15/02/2023 17:21,202212,WESTERN EUROPE-EU,ITALY,HEATHROW,NAPLES,4818,4818,0,5167,5167,0,-6.754403
15/02/2023 17:21,202212,WESTERN EUROPE-EU,ITALY,HEATHROW,PISA,2961,2961,0,1486,1486,0,99.259758
15/02/2023 17:21,202212,WESTERN EUROPE-EU,ITALY,HEATHROW,ROME (FIUMICINO),48945,48945,0,25706,25706,0,90.403019
15/02/2023 17:21,202212,WESTERN EUROPE-EU,ITALY,HEATHROW,TURIN,0,0,0,3059,3059,0,-100
15/02/2023 17:21,202212,WESTERN EUROPE-EU,ITALY,HEATHROW,VENICE,22840,22840,0,9190,9190,0,148.531012
15/02/2023 17:21,202212,WESTERN EUROPE-EU,ITALY,HEATHROW,VERONA VILLAFRANCA,0,0,0,1023,1023,0,-100
15/02/2023 17:21,202212,WESTERN EUROPE-EU,ITALY,LONDON CITY,FLORENCE,6924,6924,0,2827,2827,0,144.923948
15/02/2023 17:21,202212,WESTERN EUROPE-EU,ITALY,LONDON CITY,MILAN (LINATE),7738,7738,0,0,0,0,0
15/02/2023 17:21,202212,WESTERN EUROPE-EU,ITALY,LONDON CITY,PISA,132,132,0,0,0,0,0
15/02/2023 17:21,202212,WESTERN EUROPE-EU,ITALY,LUTON,BOLOGNA,4535,4535,0,2711,2711,0,67.281446
15/02/2023 17:21,202212,WESTERN EUROPE-EU,ITALY,LUTON,CATANIA (FONTANAROSSA),2429,2429,0,2937,2937,0,-17.296561
15/02/2023 17:21,202212,WESTERN EUROPE-EU,ITALY,LUTON,MILAN (MALPENSA),6242,6242,0,8282,8282,0,-24.631731
15/02/2023 17:21,202212,WESTERN EUROPE-EU,ITALY,LUTON,NAPLES,6864,6760,104,7813,7813,0,-12.146423
15/02/2023 17:21,202212,WESTERN EUROPE-EU,ITALY,LUTON,PALERMO,2364,2364,0,1890,1890,0,25.079365
15/02/2023 17:21,202212,WESTERN EUROPE-EU,ITALY,LUTON,ROME (FIUMICINO),0,0,0,4850,4850,0,-100
15/02/2023 17:21,202212,WESTERN EUROPE-EU,ITALY,LUTON,TURIN,1644,1644,0,594,594,0,176.767677
15/02/2023 17:21,202212,WESTERN EUROPE-EU,ITALY,STANSTED,ANCONA,5951,5951,0,3678,3678,0,61.799891
15/02/2023 17:21,202212,WESTERN EUROPE-EU,ITALY,STANSTED,BARI (PALESE),10224,10224,0,5555,5555,0,84.050405
15/02/2023 17:21,202212,WESTERN EUROPE-EU,ITALY,STANSTED,BERGAMO,44759,44759,0,18952,18952,0,136.170325
15/02/2023 17:21,202212,WESTERN EUROPE-EU,ITALY,STANSTED,BOLOGNA,13290,13290,0,6838,6838,0,94.355075
15/02/2023 17:21,202212,WESTERN EUROPE-EU,ITALY,STANSTED,BRINDISI,2467,2467,0,1630,1630,0,51.349693
15/02/2023 17:21,202212,WESTERN EUROPE-EU,ITALY,STANSTED,CAGLIARI (ELMAS),3794,3794,0,2171,2171,0,74.758176
15/02/2023 17:21,202212,WESTERN EUROPE-EU,ITALY,STANSTED,CATANIA (FONTANAROSSA),2883,2883,0,0,0,0,0
15/02/2023 17:21,202212,WESTERN EUROPE-EU,ITALY,STANSTED,GENOA,3127,3127,0,2172,2172,0,43.968692
15/02/2023 17:21,202212,WESTERN EUROPE-EU,ITALY,STANSTED,LAMETIA-TERME,3030,3030,0,1870,1870,0,62.032086
15/02/2023 17:21,202212,WESTERN EUROPE-EU,ITALY,STANSTED,MILAN (LINATE),53,53,0,0,0,0,0
15/02/2023 17:21,202212,WESTERN EUROPE-EU,ITALY,STANSTED,MILAN (MALPENSA),24332,24332,0,13705,13705,0,77.541043
15/02/2023 17:21,202212,WESTERN EUROPE-EU,ITALY,STANSTED,NAPLES,12047,12047,0,6764,6764,0,78.104672
15/02/2023 17:21,202212,WESTERN EUROPE-EU,ITALY,STANSTED,PALERMO,7644,7644,0,4540,4540,0,68.370044
15/02/2023 17:21,202212,WESTERN EUROPE-EU,ITALY,STANSTED,PERUGIA,5030,5030,0,2705,2705,0,85.951941
15/02/2023 17:21,202212,WESTERN EUROPE-EU,ITALY,STANSTED,PESCARA,6954,6954,0,3741,3741,0,85.886127
15/02/2023 17:21,202212,WESTERN EUROPE-EU,ITALY,STANSTED,PISA,13301,13301,0,6175,6175,0,115.40081
15/02/2023 17:21,202212,WESTERN EUROPE-EU,ITALY,STANSTED,ROME (CIAMPINO),45353,45353,0,15033,15033,0,201.689616
15/02/2023 17:21,202212,WESTERN EUROPE-EU,ITALY,STANSTED,ROME (FIUMICINO),150,150,0,0,0,0,0
15/02/2023 17:21,202212,WESTERN EUROPE-EU,ITALY,STANSTED,TRAPANI,0,0,0,612,612,0,-100
15/02/2023 17:21,202212,WESTERN EUROPE-EU,ITALY,STANSTED,TREVISO,0,0,0,12458,12458,0,-100
15/02/2023 17:21,202212,WESTERN EUROPE-EU,ITALY,STANSTED,TRIESTE (RONCHI DEI LEGIONARI),3341,3341,0,2188,2188,0,52.696527
15/02/2023 17:21,202212,WESTERN EUROPE-EU,ITALY,STANSTED,TURIN,12406,11844,562,8267,7820,447,50.06653
15/02/2023 17:21,202212,WESTERN EUROPE-EU,ITALY,STANSTED,VENICE,27267,27267,0,111,111,0,24464.86487
15/02/2023 17:21,202212,WESTERN EUROPE-EU,ITALY,STANSTED,VERONA VILLAFRANCA,6454,6454,0,1143,1143,0,464.654418
15/02/2023 17:21,202212,WESTERN EUROPE-EU,ITALY,BIGGIN HILL,GENOA,0,0,0,9,0,9,-100
15/02/2023 17:21,202212,WESTERN EUROPE-EU,ITALY,BIGGIN HILL,ROME (CIAMPINO),0,0,0,4,0,4,-100
15/02/2023 17:21,202212,WESTERN EUROPE-EU,ITALY,BIGGIN HILL,VENICE,4,0,4,0,0,0,0
15/02/2023 17:21,202212,WESTERN EUROPE-EU,ITALY,BIRMINGHAM,BERGAMO,2614,2614,0,1952,1952,0,33.913934
15/02/2023 17:21,202212,WESTERN EUROPE-EU,ITALY,BIRMINGHAM,NAPLES,100,52,48,0,0,0,0
15/02/2023 17:21,202212,WESTERN EUROPE-EU,ITALY,BIRMINGHAM,ROME (FIUMICINO),3347,3347,0,0,0,0,0
15/02/2023 17:21,202212,WESTERN EUROPE-EU,ITALY,BIRMINGHAM,TURIN,1813,1263,550,870,395,475,108.390805
15/02/2023 17:21,202212,WESTERN EUROPE-EU,ITALY,BIRMINGHAM,VENICE,979,979,0,0,0,0,0
15/02/2023 17:21,202212,WESTERN EUROPE-EU,ITALY,BIRMINGHAM,VERONA VILLAFRANCA,3280,2725,555,610,442,168,437.704918
15/02/2023 17:21,202212,WESTERN EUROPE-EU,ITALY,BOURNEMOUTH,VENICE,1057,1057,0,0,0,0,0
15/02/2023 17:21,202212,WESTERN EUROPE-EU,ITALY,BRISTOL,BERGAMO,3323,3323,0,2607,2607,0,27.464519
15/02/2023 17:21,202212,WESTERN EUROPE-EU,ITALY,BRISTOL,CATANIA (FONTANAROSSA),1853,1853,0,0,0,0,0
15/02/2023 17:21,202212,WESTERN EUROPE-EU,ITALY,BRISTOL,MILAN (MALPENSA),0,0,0,1406,1406,0,-100
15/02/2023 17:21,202212,WESTERN EUROPE-EU,ITALY,BRISTOL,PARMA,89,0,89,0,0,0,0
15/02/2023 17:21,202212,WESTERN EUROPE-EU,ITALY,BRISTOL,PISA,3269,3269,0,0,0,0,0
15/02/2023 17:21,202212,WESTERN EUROPE-EU,ITALY,BRISTOL,ROME (FIUMICINO),6261,6261,0,2686,2686,0,133.097543
15/02/2023 17:21,202212,WESTERN EUROPE-EU,ITALY,BRISTOL,TREVISO,2733,2733,0,1249,1249,0,118.815052
15/02/2023 17:21,202212,WESTERN EUROPE-EU,ITALY,BRISTOL,TURIN,2132,1565,567,885,764,121,140.903955
15/02/2023 17:21,202212,WESTERN EUROPE-EU,ITALY,BRISTOL,VENICE,1460,1460,0,896,896,0,62.946429
15/02/2023 17:21,202212,WESTERN EUROPE-EU,ITALY,BRISTOL,VERONA VILLAFRANCA,943,0,943,400,0,400,135.75
15/02/2023 17:21,202212,WESTERN EUROPE-EU,ITALY,CARDIFF WALES,MILAN (MALPENSA),892,892,0,0,0,0,0
15/02/2023 17:21,202212,WESTERN EUROPE-EU,ITALY,CARDIFF WALES,PARMA,84,0,84,0,0,0,0
15/02/2023 17:21,202212,WESTERN EUROPE-EU,ITALY,EAST MIDLANDS INTERNATIONAL,BERGAMO,3571,3571,0,1623,1623,0,120.024646
15/02/2023 17:21,202212,WESTERN EUROPE-EU,ITALY,EDINBURGH,BERGAMO,10125,10125,0,4785,4785,0,111.598746
15/02/2023 17:21,202212,WESTERN EUROPE-EU,ITALY,EDINBURGH,BOLOGNA,1985,1985,0,1181,1181,0,68.0779
15/02/2023 17:21,202212,WESTERN EUROPE-EU,ITALY,EDINBURGH,MILAN (MALPENSA),4606,4606,0,1251,1251,0,268.185452
15/02/2023 17:21,202212,WESTERN EUROPE-EU,ITALY,EDINBURGH,NAPLES,2318,2318,0,0,0,0,0
15/02/2023 17:21,202212,WESTERN EUROPE-EU,ITALY,EDINBURGH,PALERMO,2142,2142,0,731,731,0,193.023256
15/02/2023 17:21,202212,WESTERN EUROPE-EU,ITALY,EDINBURGH,PISA,2669,2669,0,1000,1000,0,166.9
15/02/2023 17:21,202212,WESTERN EUROPE-EU,ITALY,EDINBURGH,ROME (CIAMPINO),7017,7017,0,3774,3774,0,85.930048
15/02/2023 17:21,202212,WESTERN EUROPE-EU,ITALY,EDINBURGH,TREVISO,3039,3039,0,1144,1101,43,165.646853
15/02/2023 17:21,202212,WESTERN EUROPE-EU,ITALY,EDINBURGH,TURIN,1230,1230,0,379,379,0,224.538259
15/02/2023 17:21,202212,WESTERN EUROPE-EU,ITALY,EDINBURGH,VENICE,0,0,0,1002,960,42,-100
15/02/2023 17:21,202212,WESTERN EUROPE-EU,ITALY,EDINBURGH,VERONA VILLAFRANCA,1442,968,474,0,0,0,0
15/02/2023 17:21,202212,WESTERN EUROPE-EU,ITALY,GLASGOW,NAPLES,141,141,0,0,0,0,0
15/02/2023 17:21,202212,WESTERN EUROPE-EU,ITALY,GLASGOW,PARMA,84,0,84,0,0,0,0
15/02/2023 17:21,202212,WESTERN EUROPE-EU,ITALY,GLASGOW,ROME (FIUMICINO),2598,2598,0,0,0,0,0
15/02/2023 17:21,202212,WESTERN EUROPE-EU,ITALY,GLASGOW,TURIN,186,0,186,64,0,64,190.625
15/02/2023 17:21,202212,WESTERN EUROPE-EU,ITALY,LIVERPOOL (JOHN LENNON),BERGAMO,2361,2361,0,1097,794,303,115.223336
15/02/2023 17:21,202212,WESTERN EUROPE-EU,ITALY,LIVERPOOL (JOHN LENNON),MILAN (MALPENSA),0,0,0,288,0,288,-100
15/02/2023 17:21,202212,WESTERN EUROPE-EU,ITALY,LIVERPOOL (JOHN LENNON),ROME (CIAMPINO),3575,3575,0,0,0,0,0
15/02/2023 17:21,202212,WESTERN EUROPE-EU,ITALY,LIVERPOOL (JOHN LENNON),ROME (FIUMICINO),0,0,0,2465,2465,0,-100
15/02/2023 17:21,202212,WESTERN EUROPE-EU,ITALY,MANCHESTER,BERGAMO,14557,14557,0,7839,7839,0,85.699707
15/02/2023 17:21,202212,WESTERN EUROPE-EU,ITALY,MANCHESTER,BOLOGNA,2257,2257,0,2599,2599,0,-13.158907
15/02/2023 17:21,202212,WESTERN EUROPE-EU,ITALY,MANCHESTER,GENOA,2120,2120,0,0,0,0,0
15/02/2023 17:21,202212,WESTERN EUROPE-EU,ITALY,MANCHESTER,MILAN (MALPENSA),14734,14734,0,8987,8987,0,63.947925
15/02/2023 17:21,202212,WESTERN EUROPE-EU,ITALY,MANCHESTER,NAPLES,2410,2410,0,1339,1339,0,79.985063
15/02/2023 17:21,202212,WESTERN EUROPE-EU,ITALY,MANCHESTER,PISA,5473,5473,0,1472,1472,0,271.807065
15/02/2023 17:21,202212,WESTERN EUROPE-EU,ITALY,MANCHESTER,ROME (CIAMPINO),12500,12500,0,5005,5005,0,149.75025
15/02/2023 17:21,202212,WESTERN EUROPE-EU,ITALY,MANCHESTER,ROME (FIUMICINO),5149,5149,0,1254,1254,0,310.606061
15/02/2023 17:21,202212,WESTERN EUROPE-EU,ITALY,MANCHESTER,TREVISO,4997,4997,0,1878,1878,0,166.080937
15/02/2023 17:21,202212,WESTERN EUROPE-EU,ITALY,MANCHESTER,TURIN,3607,2080,1527,1354,420,934,166.395864
15/02/2023 17:21,202212,WESTERN EUROPE-EU,ITALY,MANCHESTER,VENICE,3809,3809,0,1782,1782,0,113.748597
15/02/2023 17:21,202212,WESTERN EUROPE-EU,ITALY,MANCHESTER,VERONA VILLAFRANCA,930,0,930,1475,974,501,-36.949153
15/02/2023 17:21,202212,WESTERN EUROPE-EU,ITALY,NEWCASTLE,BERGAMO,2820,2820,0,0,0,0,0
15/02/2023 17:21,202212,WESTERN EUROPE-EU,ITALY,NEWCASTLE,TURIN,557,557,0,255,255,0,118.431373
15/02/2023 17:21,202212,WESTERN EUROPE-EU,LUXEMBOURG,HEATHROW,LUXEMBOURG,8997,8997,0,3681,3681,0,144.417278
15/02/2023 17:21,202212,WESTERN EUROPE-EU,LUXEMBOURG,LONDON CITY,LUXEMBOURG,13864,13864,0,3049,3049,0,354.706461
15/02/2023 17:21,202212,WESTERN EUROPE-EU,LUXEMBOURG,STANSTED,LUXEMBOURG,10094,10094,0,4347,4347,0,132.206119
15/02/2023 17:21,202212,WESTERN EUROPE-EU,LUXEMBOURG,BIGGIN HILL,LUXEMBOURG,0,0,0,2,0,2,-100
15/02/2023 17:21,202212,WESTERN EUROPE-EU,MALTA,GATWICK,MALTA,21429,21429,0,7280,7280,0,194.354396
15/02/2023 17:21,202212,WESTERN EUROPE-EU,MALTA,HEATHROW,MALTA,18017,18017,0,9528,9528,0,89.095298
15/02/2023 17:21,202212,WESTERN EUROPE-EU,MALTA,LUTON,MALTA,5580,5580,0,3015,3015,0,85.074627
15/02/2023 17:21,202212,WESTERN EUROPE-EU,MALTA,STANSTED,MALTA,6545,6545,0,2730,2730,0,139.74359
15/02/2023 17:21,202212,WESTERN EUROPE-EU,MALTA,BIRMINGHAM,MALTA,2980,2980,0,1431,1431,0,108.245982
15/02/2023 17:21,202212,WESTERN EUROPE-EU,MALTA,BOURNEMOUTH,MALTA,715,715,0,0,0,0,0
15/02/2023 17:21,202212,WESTERN EUROPE-EU,MALTA,EAST MIDLANDS INTERNATIONAL,MALTA,0,0,0,950,950,0,-100
15/02/2023 17:21,202212,WESTERN EUROPE-EU,MALTA,EDINBURGH,MALTA,3371,3371,0,1519,1519,0,121.922317
15/02/2023 17:21,202212,WESTERN EUROPE-EU,MALTA,LIVERPOOL (JOHN LENNON),MALTA,2534,2534,0,1019,1019,0,148.675172
15/02/2023 17:21,202212,WESTERN EUROPE-EU,MALTA,MANCHESTER,MALTA,11606,11606,0,6258,6258,0,85.458613
15/02/2023 17:21,202212,WESTERN EUROPE-EU,NETHERLANDS,GATWICK,AMSTERDAM,69416,69416,0,11364,11364,0,510.841253
15/02/2023 17:21,202212,WESTERN EUROPE-EU,NETHERLANDS,HEATHROW,AMSTERDAM,111039,111039,0,48581,48581,0,128.564665
15/02/2023 17:21,202212,WESTERN EUROPE-EU,NETHERLANDS,LONDON CITY,AMSTERDAM,36965,36965,0,10639,10639,0,247.448068
15/02/2023 17:21,202212,WESTERN EUROPE-EU,NETHERLANDS,LONDON CITY,ROTTERDAM,11220,11220,0,0,0,0,0
15/02/2023 17:21,202212,WESTERN EUROPE-EU,NETHERLANDS,LUTON,AMSTERDAM,39584,39584,0,8512,8512,0,365.037594
15/02/2023 17:21,202212,WESTERN EUROPE-EU,NETHERLANDS,STANSTED,AMSTERDAM,15089,15089,0,3350,3350,0,350.41791
15/02/2023 17:21,202212,WESTERN EUROPE-EU,NETHERLANDS,STANSTED,EINDHOVEN,25919,25919,0,9175,9175,0,182.495913
15/02/2023 17:21,202212,WESTERN EUROPE-EU,NETHERLANDS,STANSTED,MAASTRICHT,2784,2784,0,0,0,0,0
15/02/2023 17:21,202212,WESTERN EUROPE-EU,NETHERLANDS,ABERDEEN,AMSTERDAM,18167,18167,0,12686,12686,0,43.205108
15/02/2023 17:21,202212,WESTERN EUROPE-EU,NETHERLANDS,BELFAST CITY (GEORGE BEST),AMSTERDAM,4536,4536,0,2007,2007,0,126.008969
15/02/2023 17:21,202212,WESTERN EUROPE-EU,NETHERLANDS,BELFAST INTERNATIONAL,AMSTERDAM,6925,6925,0,1241,1241,0,458.017728
15/02/2023 17:21,202212,WESTERN EUROPE-EU,NETHERLANDS,BIRMINGHAM,AMSTERDAM,32909,32909,0,16830,16830,0,95.53773
15/02/2023 17:21,202212,WESTERN EUROPE-EU,NETHERLANDS,BRISTOL,AMSTERDAM,31273,31273,0,9239,9239,0,238.489014
15/02/2023 17:21,202212,WESTERN EUROPE-EU,NETHERLANDS,CARDIFF WALES,AMSTERDAM,7670,7670,0,1748,1748,0,338.787185
15/02/2023 17:21,202212,WESTERN EUROPE-EU,NETHERLANDS,EAST MIDLANDS INTERNATIONAL,AMSTERDAM,3126,3126,0,0,0,0,0
15/02/2023 17:21,202212,WESTERN EUROPE-EU,NETHERLANDS,EDINBURGH,AMSTERDAM,36492,36492,0,17107,17107,0,113.316186
15/02/2023 17:21,202212,WESTERN EUROPE-EU,NETHERLANDS,EDINBURGH,EINDHOVEN,2298,2298,0,685,685,0,235.474453
15/02/2023 17:21,202212,WESTERN EUROPE-EU,NETHERLANDS,EDINBURGH,ROTTERDAM,2055,2055,0,0,0,0,0
15/02/2023 17:21,202212,WESTERN EUROPE-EU,NETHERLANDS,GLASGOW,AMSTERDAM,24287,24287,0,13386,13386,0,81.435828
15/02/2023 17:21,202212,WESTERN EUROPE-EU,NETHERLANDS,HUMBERSIDE,AMSTERDAM,5374,5374,0,942,942,0,470.488323
15/02/2023 17:21,202212,WESTERN EUROPE-EU,NETHERLANDS,INVERNESS,AMSTERDAM,2601,2601,0,1262,1262,0,106.101426
15/02/2023 17:21,202212,WESTERN EUROPE-EU,NETHERLANDS,LEEDS BRADFORD,AMSTERDAM,9123,9051,72,5875,5875,0,55.285106
15/02/2023 17:21,202212,WESTERN EUROPE-EU,NETHERLANDS,LIVERPOOL (JOHN LENNON),AMSTERDAM,8279,8279,0,2202,2202,0,275.976385
15/02/2023 17:21,202212,WESTERN EUROPE-EU,NETHERLANDS,MANCHESTER,AMSTERDAM,63341,63341,0,26859,26859,0,135.827842
15/02/2023 17:21,202212,WESTERN EUROPE-EU,NETHERLANDS,MANCHESTER,EINDHOVEN,3258,3258,0,2281,2281,0,42.832091
15/02/2023 17:21,202212,WESTERN EUROPE-EU,NETHERLANDS,NEWCASTLE,AMSTERDAM,19859,19859,0,14287,14287,0,39.00049
15/02/2023 17:21,202212,WESTERN EUROPE-EU,NETHERLANDS,NORWICH,AMSTERDAM,8081,8081,0,1439,1439,0,461.570535
15/02/2023 17:21,202212,WESTERN EUROPE-EU,NETHERLANDS,NORWICH,GRONINGEN,154,154,0,0,0,0,0
15/02/2023 17:21,202212,WESTERN EUROPE-EU,NETHERLANDS,SOUTHAMPTON,AMSTERDAM,6671,6575,96,1272,1272,0,424.449686
15/02/2023 17:21,202212,WESTERN EUROPE-EU,NETHERLANDS,TEESSIDE INTERNATIONAL AIRPORT,AMSTERDAM,5856,5856,0,788,788,0,643.147208
15/02/2023 17:21,202212,WESTERN EUROPE-EU,PORTUGAL(EXCLUDING MADEIRA),GATWICK,FARO,31691,31691,0,8248,8248,0,284.226479
15/02/2023 17:21,202212,WESTERN EUROPE-EU,PORTUGAL(EXCLUDING MADEIRA),GATWICK,LISBON,32196,32196,0,19368,19368,0,66.232962
15/02/2023 17:21,202212,WESTERN EUROPE-EU,PORTUGAL(EXCLUDING MADEIRA),GATWICK,OPORTO (PORTUGAL),22075,22075,0,11968,11968,0,84.450201
15/02/2023 17:21,202212,WESTERN EUROPE-EU,PORTUGAL(EXCLUDING MADEIRA),HEATHROW,FARO,0,0,0,3757,3757,0,-100
15/02/2023 17:21,202212,WESTERN EUROPE-EU,PORTUGAL(EXCLUDING MADEIRA),HEATHROW,LISBON,75432,75432,0,38425,38425,0,96.309694
15/02/2023 17:21,202212,WESTERN EUROPE-EU,PORTUGAL(EXCLUDING MADEIRA),HEATHROW,OPORTO (PORTUGAL),4829,4829,0,3895,3895,0,23.979461
15/02/2023 17:21,202212,WESTERN EUROPE-EU,PORTUGAL(EXCLUDING MADEIRA),LUTON,FARO,11852,11852,0,4089,4089,0,189.850819
15/02/2023 17:21,202212,WESTERN EUROPE-EU,PORTUGAL(EXCLUDING MADEIRA),LUTON,LISBON,21104,21104,0,6866,6866,0,207.369648
15/02/2023 17:21,202212,WESTERN EUROPE-EU,PORTUGAL(EXCLUDING MADEIRA),LUTON,OPORTO (PORTUGAL),10507,10507,0,4861,4861,0,116.148941
15/02/2023 17:21,202212,WESTERN EUROPE-EU,PORTUGAL(EXCLUDING MADEIRA),STANSTED,AZORES PONTA DELGADA,0,0,0,535,535,0,-100
15/02/2023 17:21,202212,WESTERN EUROPE-EU,PORTUGAL(EXCLUDING MADEIRA),STANSTED,FARO,14621,14621,0,8412,8412,0,73.811222
15/02/2023 17:21,202212,WESTERN EUROPE-EU,PORTUGAL(EXCLUDING MADEIRA),STANSTED,LISBON,37362,37362,0,24785,24785,0,50.744402
15/02/2023 17:21,202212,WESTERN EUROPE-EU,PORTUGAL(EXCLUDING MADEIRA),STANSTED,OPORTO (PORTUGAL),27031,27031,0,15867,15867,0,70.359866
15/02/2023 17:21,202212,WESTERN EUROPE-EU,PORTUGAL(EXCLUDING MADEIRA),BELFAST INTERNATIONAL,FARO,2202,2202,0,760,760,0,189.736842
15/02/2023 17:21,202212,WESTERN EUROPE-EU,PORTUGAL(EXCLUDING MADEIRA),BELFAST INTERNATIONAL,LISBON,22,0,22,0,0,0,0
15/02/2023 17:21,202212,WESTERN EUROPE-EU,PORTUGAL(EXCLUDING MADEIRA),BIGGIN HILL,FARO,6,0,6,0,0,0,0
15/02/2023 17:21,202212,WESTERN EUROPE-EU,PORTUGAL(EXCLUDING MADEIRA),BIRMINGHAM,FARO,8327,8327,0,3150,3150,0,164.349206
15/02/2023 17:21,202212,WESTERN EUROPE-EU,PORTUGAL(EXCLUDING MADEIRA),BIRMINGHAM,LISBON,5654,5654,0,1857,1857,0,204.469575
15/02/2023 17:21,202212,WESTERN EUROPE-EU,PORTUGAL(EXCLUDING MADEIRA),BIRMINGHAM,OPORTO (PORTUGAL),2182,2182,0,1743,1743,0,25.18646
15/02/2023 17:21,202212,WESTERN EUROPE-EU,PORTUGAL(EXCLUDING MADEIRA),BOURNEMOUTH,FARO,2716,2716,0,949,949,0,186.195996
15/02/2023 17:21,202212,WESTERN EUROPE-EU,PORTUGAL(EXCLUDING MADEIRA),BOURNEMOUTH,LISBON,0,0,0,923,923,0,-100
15/02/2023 17:21,202212,WESTERN EUROPE-EU,PORTUGAL(EXCLUDING MADEIRA),BRISTOL,FARO,8998,8998,0,4320,4320,0,108.287037
15/02/2023 17:21,202212,WESTERN EUROPE-EU,PORTUGAL(EXCLUDING MADEIRA),BRISTOL,LISBON,7407,7407,0,3266,3266,0,126.791182
15/02/2023 17:21,202212,WESTERN EUROPE-EU,PORTUGAL(EXCLUDING MADEIRA),BRISTOL,OPORTO (PORTUGAL),3828,3828,0,1842,1842,0,107.81759
15/02/2023 17:21,202212,WESTERN EUROPE-EU,PORTUGAL(EXCLUDING MADEIRA),CARDIFF WALES,FARO,1375,1375,0,0,0,0,0
15/02/2023 17:21,202212,WESTERN EUROPE-EU,PORTUGAL(EXCLUDING MADEIRA),EAST MIDLANDS INTERNATIONAL,FARO,4803,4803,0,1326,1326,0,262.217195
15/02/2023 17:21,202212,WESTERN EUROPE-EU,PORTUGAL(EXCLUDING MADEIRA),EDINBURGH,FARO,2810,2810,0,1232,1232,0,128.084416
15/02/2023 17:21,202212,WESTERN EUROPE-EU,PORTUGAL(EXCLUDING MADEIRA),EDINBURGH,LISBON,7331,7331,0,3595,3595,0,103.922114
15/02/2023 17:21,202212,WESTERN EUROPE-EU,PORTUGAL(EXCLUDING MADEIRA),EDINBURGH,OPORTO (PORTUGAL),2865,2865,0,1394,1394,0,105.523673
15/02/2023 17:21,202212,WESTERN EUROPE-EU,PORTUGAL(EXCLUDING MADEIRA),EXETER,FARO,0,0,0,126,126,0,-100
15/02/2023 17:21,202212,WESTERN EUROPE-EU,PORTUGAL(EXCLUDING MADEIRA),GLASGOW,FARO,3010,2909,101,736,736,0,308.967391
15/02/2023 17:21,202212,WESTERN EUROPE-EU,PORTUGAL(EXCLUDING MADEIRA),LEEDS BRADFORD,FARO,3362,3362,0,1656,1656,0,103.019324
15/02/2023 17:21,202212,WESTERN EUROPE-EU,PORTUGAL(EXCLUDING MADEIRA),LIVERPOOL (JOHN LENNON),FARO,4230,4230,0,1331,1331,0,217.806161
15/02/2023 17:21,202212,WESTERN EUROPE-EU,PORTUGAL(EXCLUDING MADEIRA),MANCHESTER,FARO,12633,12633,0,5995,5995,0,110.725605
15/02/2023 17:21,202212,WESTERN EUROPE-EU,PORTUGAL(EXCLUDING MADEIRA),MANCHESTER,LISBON,20218,20218,0,11710,11710,0,72.65585
15/02/2023 17:21,202212,WESTERN EUROPE-EU,PORTUGAL(EXCLUDING MADEIRA),MANCHESTER,OPORTO (PORTUGAL),5399,5399,0,2814,2814,0,91.862118
15/02/2023 17:21,202212,WESTERN EUROPE-EU,PORTUGAL(EXCLUDING MADEIRA),NEWCASTLE,FARO,4590,4590,0,1151,1151,0,298.783666
15/02/2023 17:21,202212,WESTERN EUROPE-EU,PORTUGAL(EXCLUDING MADEIRA),PRESTWICK,FARO,0,0,0,772,772,0,-100
15/02/2023 17:21,202212,WESTERN EUROPE-EU,PORTUGAL(MADEIRA),GATWICK,FUNCHAL,17287,17287,0,10602,10602,0,63.054141
15/02/2023 17:21,202212,WESTERN EUROPE-EU,PORTUGAL(MADEIRA),GATWICK,PORTO SANTO,0,0,0,118,118,0,-100
15/02/2023 17:21,202212,WESTERN EUROPE-EU,PORTUGAL(MADEIRA),HEATHROW,FUNCHAL,5533,5533,0,6310,6310,0,-12.313788
15/02/2023 17:21,202212,WESTERN EUROPE-EU,PORTUGAL(MADEIRA),LUTON,FUNCHAL,1907,1907,0,1788,1788,0,6.655481
15/02/2023 17:21,202212,WESTERN EUROPE-EU,PORTUGAL(MADEIRA),STANSTED,FUNCHAL,10132,10132,0,1831,1831,0,453.35882
15/02/2023 17:21,202212,WESTERN EUROPE-EU,PORTUGAL(MADEIRA),BIRMINGHAM,FUNCHAL,4290,2592,1698,2605,1410,1195,64.683301
15/02/2023 17:21,202212,WESTERN EUROPE-EU,PORTUGAL(MADEIRA),BRISTOL,FUNCHAL,4169,4169,0,2518,2518,0,65.567911
15/02/2023 17:21,202212,WESTERN EUROPE-EU,PORTUGAL(MADEIRA),CARDIFF WALES,FUNCHAL,135,135,0,0,0,0,0
15/02/2023 17:21,202212,WESTERN EUROPE-EU,PORTUGAL(MADEIRA),EAST MIDLANDS INTERNATIONAL,FUNCHAL,1117,1117,0,580,580,0,92.586207
15/02/2023 17:21,202212,WESTERN EUROPE-EU,PORTUGAL(MADEIRA),EDINBURGH,FUNCHAL,1275,1275,0,678,678,0,88.053097
15/02/2023 17:21,202212,WESTERN EUROPE-EU,PORTUGAL(MADEIRA),GLASGOW,FUNCHAL,1176,1176,0,536,536,0,119.402985
15/02/2023 17:21,202212,WESTERN EUROPE-EU,PORTUGAL(MADEIRA),JERSEY,FUNCHAL,1206,0,1206,1185,0,1185,1.772152
15/02/2023 17:21,202212,WESTERN EUROPE-EU,PORTUGAL(MADEIRA),LEEDS BRADFORD,FUNCHAL,1465,1465,0,920,920,0,59.23913
15/02/2023 17:21,202212,WESTERN EUROPE-EU,PORTUGAL(MADEIRA),MANCHESTER,FUNCHAL,10612,8654,1958,4456,2666,1790,138.150808
15/02/2023 17:21,202212,WESTERN EUROPE-EU,PORTUGAL(MADEIRA),NEWCASTLE,FUNCHAL,1098,1098,0,691,691,0,58.900145
15/02/2023 17:21,202212,WESTERN EUROPE-EU,SLOVENIA,GATWICK,LJUBLJANA,3291,3291,0,2500,2500,0,31.64
15/02/2023 17:21,202212,WESTERN EUROPE-EU,SLOVENIA,LUTON,LJUBLJANA,4203,4203,0,1425,1425,0,194.947368
15/02/2023 17:21,202212,WESTERN EUROPE-EU,SPAIN,GATWICK,A CORUNA,4466,4466,0,0,0,0,0
15/02/2023 17:21,202212,WESTERN EUROPE-EU,SPAIN,GATWICK,ALICANTE,38086,38086,0,18753,18753,0,103.092838
15/02/2023 17:21,202212,WESTERN EUROPE-EU,SPAIN,GATWICK,ALMERIA,2849,2849,0,3018,3018,0,-5.599735
15/02/2023 17:21,202212,WESTERN EUROPE-EU,SPAIN,GATWICK,ASTURIAS,4158,4158,0,0,0,0,0
15/02/2023 17:21,202212,WESTERN EUROPE-EU,SPAIN,GATWICK,BARCELONA,77580,77580,0,27513,27125,388,181.975793
15/02/2023 17:21,202212,WESTERN EUROPE-EU,SPAIN,GATWICK,BILBAO,21472,21472,0,5514,5514,0,289.408778
15/02/2023 17:21,202212,WESTERN EUROPE-EU,SPAIN,GATWICK,GRANADA,2140,2140,0,0,0,0,0
15/02/2023 17:21,202212,WESTERN EUROPE-EU,SPAIN,GATWICK,MADRID,59643,59643,0,23265,23265,0,156.363636
15/02/2023 17:21,202212,WESTERN EUROPE-EU,SPAIN,GATWICK,MAHON,1785,1785,0,849,849,0,110.24735
15/02/2023 17:21,202212,WESTERN EUROPE-EU,SPAIN,GATWICK,MALAGA,63983,63590,393,18947,18253,694,237.694622
15/02/2023 17:21,202212,WESTERN EUROPE-EU,SPAIN,GATWICK,MURCIA INTERNATIONAL,6878,6878,0,3911,3911,0,75.862951
15/02/2023 17:21,202212,WESTERN EUROPE-EU,SPAIN,GATWICK,PALMA DE MALLORCA,24349,24349,0,7134,7134,0,241.309223
15/02/2023 17:21,202212,WESTERN EUROPE-EU,SPAIN,GATWICK,SANTIAGO DE COMPOSTELA (SPAIN),5009,5009,0,2565,2565,0,95.282651
15/02/2023 17:21,202212,WESTERN EUROPE-EU,SPAIN,GATWICK,SEVILLE,25016,25016,0,4159,4159,0,501.490743
15/02/2023 17:21,202212,WESTERN EUROPE-EU,SPAIN,GATWICK,VALENCIA,22150,22150,0,5718,5718,0,287.373207
15/02/2023 17:21,202212,WESTERN EUROPE-EU,SPAIN,HEATHROW,BARCELONA,49873,49873,0,23323,23323,0,113.836127
15/02/2023 17:21,202212,WESTERN EUROPE-EU,SPAIN,HEATHROW,BILBAO,0,0,0,1980,1980,0,-100
15/02/2023 17:21,202212,WESTERN EUROPE-EU,SPAIN,HEATHROW,MADRID,110385,110385,0,58238,58238,0,89.541193
15/02/2023 17:21,202212,WESTERN EUROPE-EU,SPAIN,HEATHROW,MALAGA,7720,7720,0,11865,11865,0,-34.934682
15/02/2023 17:21,202212,WESTERN EUROPE-EU,SPAIN,HEATHROW,PALMA DE MALLORCA,0,0,0,1422,1422,0,-100
15/02/2023 17:21,202212,WESTERN EUROPE-EU,SPAIN,HEATHROW,SEVILLE,0,0,0,1757,1757,0,-100
15/02/2023 17:21,202212,WESTERN EUROPE-EU,SPAIN,HEATHROW,VALENCIA,6611,6611,0,2799,2799,0,136.191497
15/02/2023 17:21,202212,WESTERN EUROPE-EU,SPAIN,LONDON CITY,BARCELONA,3729,3729,0,0,0,0,0
15/02/2023 17:21,202212,WESTERN EUROPE-EU,SPAIN,LONDON CITY,IBIZA,4909,4909,0,3727,3727,0,31.714516
15/02/2023 17:21,202212,WESTERN EUROPE-EU,SPAIN,LONDON CITY,MALAGA,2129,2129,0,1749,1749,0,21.726701
15/02/2023 17:21,202212,WESTERN EUROPE-EU,SPAIN,LONDON CITY,PALMA DE MALLORCA,1296,1296,0,1189,1189,0,8.999159
15/02/2023 17:21,202212,WESTERN EUROPE-EU,SPAIN,LUTON,ALICANTE,13351,13351,0,6492,6492,0,105.653112
15/02/2023 17:21,202212,WESTERN EUROPE-EU,SPAIN,LUTON,ALMERIA,158,158,0,0,0,0,0
15/02/2023 17:21,202212,WESTERN EUROPE-EU,SPAIN,LUTON,BARCELONA,8685,8685,0,5676,5676,0,53.012685
15/02/2023 17:21,202212,WESTERN EUROPE-EU,SPAIN,LUTON,MADRID,2915,2915,0,0,0,0,0
15/02/2023 17:21,202212,WESTERN EUROPE-EU,SPAIN,LUTON,MALAGA,17863,17863,0,9806,9806,0,82.163981
15/02/2023 17:21,202212,WESTERN EUROPE-EU,SPAIN,LUTON,PALMA DE MALLORCA,2375,2375,0,1919,1919,0,23.762376
15/02/2023 17:21,202212,WESTERN EUROPE-EU,SPAIN,LUTON,SEVILLE,2254,2254,0,1433,1433,0,57.292394
15/02/2023 17:21,202212,WESTERN EUROPE-EU,SPAIN,STANSTED,ALICANTE,24730,24730,0,13181,13181,0,87.618542
15/02/2023 17:21,202212,WESTERN EUROPE-EU,SPAIN,STANSTED,ASTURIAS,3335,3335,0,0,0,0,0
15/02/2023 17:21,202212,WESTERN EUROPE-EU,SPAIN,STANSTED,BARCELONA,37883,37883,0,18737,18737,0,102.182847
15/02/2023 17:21,202212,WESTERN EUROPE-EU,SPAIN,STANSTED,CASTELLON COSTA AZAHAR,2677,2677,0,1331,1331,0,101.126972
15/02/2023 17:21,202212,WESTERN EUROPE-EU,SPAIN,STANSTED,GIRONA,2340,2340,0,1503,1503,0,55.688623
15/02/2023 17:21,202212,WESTERN EUROPE-EU,SPAIN,STANSTED,MADRID,36153,36153,0,22000,22000,0,64.331818
15/02/2023 17:21,202212,WESTERN EUROPE-EU,SPAIN,STANSTED,MALAGA,22710,22710,0,9635,9635,0,135.703166
15/02/2023 17:21,202212,WESTERN EUROPE-EU,SPAIN,STANSTED,PALMA DE MALLORCA,9993,9993,0,4130,4130,0,141.961259
15/02/2023 17:21,202212,WESTERN EUROPE-EU,SPAIN,STANSTED,SANTANDER,5543,5543,0,4153,4153,0,33.469781
15/02/2023 17:21,202212,WESTERN EUROPE-EU,SPAIN,STANSTED,SANTIAGO DE COMPOSTELA (SPAIN),4800,4800,0,3461,3461,0,38.68824
15/02/2023 17:21,202212,WESTERN EUROPE-EU,SPAIN,STANSTED,SEVILLE,10461,10461,0,7023,7023,0,48.953439
15/02/2023 17:21,202212,WESTERN EUROPE-EU,SPAIN,STANSTED,VALENCIA,16511,16511,0,8538,8538,0,93.382525
15/02/2023 17:21,202212,WESTERN EUROPE-EU,SPAIN,STANSTED,ZARAGOZA,6259,6259,0,4031,4031,0,55.271645
15/02/2023 17:21,202212,WESTERN EUROPE-EU,SPAIN,ABERDEEN,ALICANTE,2680,2680,0,1412,1412,0,89.8017
15/02/2023 17:21,202212,WESTERN EUROPE-EU,SPAIN,BELFAST INTERNATIONAL,ALICANTE,7374,7374,0,3892,3892,0,89.46557
15/02/2023 17:21,202212,WESTERN EUROPE-EU,SPAIN,BELFAST INTERNATIONAL,MALAGA,4947,4947,0,2439,2439,0,102.829028
15/02/2023 17:21,202212,WESTERN EUROPE-EU,SPAIN,BIGGIN HILL,GRANADA,8,0,8,0,0,0,0
15/02/2023 17:21,202212,WESTERN EUROPE-EU,SPAIN,BIGGIN HILL,MADRID,12,0,12,2,0,2,500
15/02/2023 17:21,202212,WESTERN EUROPE-EU,SPAIN,BIGGIN HILL,MAHON,0,0,0,10,0,10,-100
15/02/2023 17:21,202212,WESTERN EUROPE-EU,SPAIN,BIGGIN HILL,MALAGA,0,0,0,9,0,9,-100
15/02/2023 17:21,202212,WESTERN EUROPE-EU,SPAIN,BIGGIN HILL,PALMA DE MALLORCA,0,0,0,10,0,10,-100
15/02/2023 17:21,202212,WESTERN EUROPE-EU,SPAIN,BIRMINGHAM,ALICANTE,18678,18678,0,9544,9544,0,95.704107
15/02/2023 17:21,202212,WESTERN EUROPE-EU,SPAIN,BIRMINGHAM,BARCELONA,16599,16599,0,6994,6698,296,137.331999
15/02/2023 17:21,202212,WESTERN EUROPE-EU,SPAIN,BIRMINGHAM,MADRID,3336,3336,0,2281,2281,0,46.251644
15/02/2023 17:21,202212,WESTERN EUROPE-EU,SPAIN,BIRMINGHAM,MALAGA,14460,13881,579,7473,6199,1274,93.496588
15/02/2023 17:21,202212,WESTERN EUROPE-EU,SPAIN,BIRMINGHAM,MURCIA INTERNATIONAL,2487,2487,0,1384,1384,0,79.696532
15/02/2023 17:21,202212,WESTERN EUROPE-EU,SPAIN,BIRMINGHAM,PALMA DE MALLORCA,1499,1499,0,0,0,0,0
15/02/2023 17:21,202212,WESTERN EUROPE-EU,SPAIN,BIRMINGHAM,SANTANDER,2384,2384,0,0,0,0,0
15/02/2023 17:21,202212,WESTERN EUROPE-EU,SPAIN,BIRMINGHAM,VALENCIA,0,0,0,59,59,0,-100
15/02/2023 17:21,202212,WESTERN EUROPE-EU,SPAIN,BOURNEMOUTH,ALICANTE,4547,4547,0,2297,2297,0,97.953853
15/02/2023 17:21,202212,WESTERN EUROPE-EU,SPAIN,BOURNEMOUTH,MALAGA,3313,3249,64,1728,1728,0,91.724537
15/02/2023 17:21,202212,WESTERN EUROPE-EU,SPAIN,BRISTOL,ALICANTE,17780,17780,0,9227,9227,0,92.695351
15/02/2023 17:21,202212,WESTERN EUROPE-EU,SPAIN,BRISTOL,BARCELONA,15581,15581,0,6800,6800,0,129.132353
15/02/2023 17:21,202212,WESTERN EUROPE-EU,SPAIN,BRISTOL,MADRID,9140,9140,0,6563,6563,0,39.26558
15/02/2023 17:21,202212,WESTERN EUROPE-EU,SPAIN,BRISTOL,MALAGA,17364,17364,0,7987,7987,0,117.40328
15/02/2023 17:21,202212,WESTERN EUROPE-EU,SPAIN,BRISTOL,PALMA DE MALLORCA,3394,3394,0,1891,1891,0,79.481756
15/02/2023 17:21,202212,WESTERN EUROPE-EU,SPAIN,BRISTOL,SEVILLE,0,0,0,1394,1394,0,-100
15/02/2023 17:21,202212,WESTERN EUROPE-EU,SPAIN,BRISTOL,VALENCIA,2215,2215,0,1261,1261,0,75.654243
15/02/2023 17:21,202212,WESTERN EUROPE-EU,SPAIN,CARDIFF WALES,ALICANTE,5309,2201,3108,2006,999,1007,164.656032
15/02/2023 17:21,202212,WESTERN EUROPE-EU,SPAIN,CARDIFF WALES,IBIZA,54,54,0,0,0,0,0
15/02/2023 17:21,202212,WESTERN EUROPE-EU,SPAIN,CARDIFF WALES,MALAGA,1394,1394,0,894,437,457,55.928412
15/02/2023 17:21,202212,WESTERN EUROPE-EU,SPAIN,CARDIFF WALES,PALMA DE MALLORCA,190,190,0,0,0,0,0
15/02/2023 17:21,202212,WESTERN EUROPE-EU,SPAIN,DONCASTER SHEFFIELD,ALICANTE,0,0,0,1559,0,1559,-100
15/02/2023 17:21,202212,WESTERN EUROPE-EU,SPAIN,DONCASTER SHEFFIELD,MALAGA,0,0,0,716,0,716,-100
15/02/2023 17:21,202212,WESTERN EUROPE-EU,SPAIN,EAST MIDLANDS INTERNATIONAL,ALICANTE,17930,16466,1464,9256,8486,770,93.712187
15/02/2023 17:21,202212,WESTERN EUROPE-EU,SPAIN,EAST MIDLANDS INTERNATIONAL,BARCELONA,137,58,79,0,0,0,0
15/02/2023 17:21,202212,WESTERN EUROPE-EU,SPAIN,EAST MIDLANDS INTERNATIONAL,MALAGA,11153,9848,1305,4621,4532,89,141.354685
15/02/2023 17:21,202212,WESTERN EUROPE-EU,SPAIN,EDINBURGH,ALICANTE,15678,15678,0,5177,5177,0,202.839482
15/02/2023 17:21,202212,WESTERN EUROPE-EU,SPAIN,EDINBURGH,BARCELONA,12513,12513,0,5564,5564,0,124.892164
15/02/2023 17:21,202212,WESTERN EUROPE-EU,SPAIN,EDINBURGH,MADRID,12201,12201,0,5447,5447,0,123.99486
15/02/2023 17:21,202212,WESTERN EUROPE-EU,SPAIN,EDINBURGH,MALAGA,9261,9261,0,3670,3670,0,152.343324
15/02/2023 17:21,202212,WESTERN EUROPE-EU,SPAIN,EDINBURGH,SANTANDER,2406,2406,0,1518,1518,0,58.498024
15/02/2023 17:21,202212,WESTERN EUROPE-EU,SPAIN,EDINBURGH,SANTIAGO DE COMPOSTELA (SPAIN),2274,2274,0,0,0,0,0
15/02/2023 17:21,202212,WESTERN EUROPE-EU,SPAIN,EDINBURGH,SEVILLE,2584,2584,0,1044,1001,43,147.509579
15/02/2023 17:21,202212,WESTERN EUROPE-EU,SPAIN,EDINBURGH,VALENCIA,2517,2517,0,0,0,0,0
15/02/2023 17:21,202212,WESTERN EUROPE-EU,SPAIN,EXETER,ALICANTE,794,794,0,564,564,0,40.780142
15/02/2023 17:21,202212,WESTERN EUROPE-EU,SPAIN,EXETER,MALAGA,1432,1432,0,529,529,0,170.699433
15/02/2023 17:21,202212,WESTERN EUROPE-EU,SPAIN,GLASGOW,ALICANTE,15189,14018,1171,5549,5019,530,173.724995
15/02/2023 17:21,202212,WESTERN EUROPE-EU,SPAIN,GLASGOW,MALAGA,7140,6867,273,3699,3699,0,93.025142
15/02/2023 17:21,202212,WESTERN EUROPE-EU,SPAIN,GLASGOW,SEVILLE,0,0,0,141,0,141,-100
15/02/2023 17:21,202212,WESTERN EUROPE-EU,SPAIN,JERSEY,MALAGA,0,0,0,69,69,0,-100
15/02/2023 17:21,202212,WESTERN EUROPE-EU,SPAIN,LEEDS BRADFORD,ALICANTE,15095,15095,0,4871,4871,0,209.895299
15/02/2023 17:21,202212,WESTERN EUROPE-EU,SPAIN,LEEDS BRADFORD,MALAGA,9887,9887,0,4837,4837,0,104.403556
15/02/2023 17:21,202212,WESTERN EUROPE-EU,SPAIN,LEEDS BRADFORD,SAN SEBASTIAN,120,0,120,0,0,0,0
15/02/2023 17:21,202212,WESTERN EUROPE-EU,SPAIN,LEEDS BRADFORD,VALENCIA,103,50,53,0,0,0,0
15/02/2023 17:21,202212,WESTERN EUROPE-EU,SPAIN,LIVERPOOL (JOHN LENNON),ALICANTE,13672,13672,0,6822,6822,0,100.410437
15/02/2023 17:21,202212,WESTERN EUROPE-EU,SPAIN,LIVERPOOL (JOHN LENNON),BARCELONA,3545,3545,0,1845,1845,0,92.140921
15/02/2023 17:21,202212,WESTERN EUROPE-EU,SPAIN,LIVERPOOL (JOHN LENNON),MALAGA,10404,10404,0,4385,4385,0,137.263398
15/02/2023 17:21,202212,WESTERN EUROPE-EU,SPAIN,LIVERPOOL (JOHN LENNON),PALMA DE MALLORCA,2831,2831,0,1116,1116,0,153.673835
15/02/2023 17:21,202212,WESTERN EUROPE-EU,SPAIN,MANCHESTER,ALICANTE,43415,39111,4304,22966,21531,1435,89.04032
15/02/2023 17:21,202212,WESTERN EUROPE-EU,SPAIN,MANCHESTER,BARCELONA,26963,26963,0,14374,14112,262,87.581745
15/02/2023 17:21,202212,WESTERN EUROPE-EU,SPAIN,MANCHESTER,BILBAO,2743,2743,0,1471,1471,0,86.471788
15/02/2023 17:21,202212,WESTERN EUROPE-EU,SPAIN,MANCHESTER,GIRONA,101,0,101,0,0,0,0
15/02/2023 17:21,202212,WESTERN EUROPE-EU,SPAIN,MANCHESTER,JEREZ,67,0,67,0,0,0,0
15/02/2023 17:21,202212,WESTERN EUROPE-EU,SPAIN,MANCHESTER,MADRID,16759,16759,0,9806,9806,0,70.905568
15/02/2023 17:21,202212,WESTERN EUROPE-EU,SPAIN,MANCHESTER,MALAGA,27672,24537,3135,17519,15415,2104,57.954221
15/02/2023 17:21,202212,WESTERN EUROPE-EU,SPAIN,MANCHESTER,MURCIA INTERNATIONAL,3252,3252,0,2532,2532,0,28.436019
15/02/2023 17:21,202212,WESTERN EUROPE-EU,SPAIN,MANCHESTER,PALMA DE MALLORCA,7941,7941,0,3897,3897,0,103.772132
15/02/2023 17:21,202212,WESTERN EUROPE-EU,SPAIN,MANCHESTER,SANTANDER,2327,2327,0,1434,1434,0,62.273361
15/02/2023 17:21,202212,WESTERN EUROPE-EU,SPAIN,MANCHESTER,SEVILLE,3834,3774,60,2121,2121,0,80.763791
15/02/2023 17:21,202212,WESTERN EUROPE-EU,SPAIN,MANCHESTER,VALENCIA,4565,4565,0,2179,2179,0,109.499771
15/02/2023 17:21,202212,WESTERN EUROPE-EU,SPAIN,NEWCASTLE,ALICANTE,11198,11198,0,6478,6478,0,72.861994
15/02/2023 17:21,202212,WESTERN EUROPE-EU,SPAIN,NEWCASTLE,BARCELONA,2743,2743,0,0,0,0,0
15/02/2023 17:21,202212,WESTERN EUROPE-EU,SPAIN,NEWCASTLE,MADRID,86,0,86,0,0,0,0
15/02/2023 17:21,202212,WESTERN EUROPE-EU,SPAIN,NEWCASTLE,MALAGA,7261,7261,0,3230,3230,0,124.798762
15/02/2023 17:21,202212,WESTERN EUROPE-EU,SPAIN,NEWQUAY,ALICANTE,2470,2470,0,1066,1066,0,131.707317
15/02/2023 17:21,202212,WESTERN EUROPE-EU,SPAIN,PRESTWICK,ALICANTE,3241,3241,0,2506,2506,0,29.329609
15/02/2023 17:21,202212,WESTERN EUROPE-EU,SPAIN,PRESTWICK,MALAGA,2143,2143,0,1179,1179,0,81.764207
15/02/2023 17:21,202212,WESTERN EUROPE-EU,SPAIN,TEESSIDE INTERNATIONAL AIRPORT,ALICANTE,2528,2528,0,1159,1159,0,118.119068
15/02/2023 17:21,202212,WESTERN EUROPE-EU,SPAIN(CANARY ISLANDS),GATWICK,ARRECIFE,29689,26120,3569,14585,11858,2727,103.55845
15/02/2023 17:21,202212,WESTERN EUROPE-EU,SPAIN(CANARY ISLANDS),GATWICK,FUERTEVENTURA,14587,11741,2846,7436,5076,2360,96.167294
15/02/2023 17:21,202212,WESTERN EUROPE-EU,SPAIN(CANARY ISLANDS),GATWICK,LAS PALMAS,23050,18301,4749,10430,7295,3135,120.997124
15/02/2023 17:21,202212,WESTERN EUROPE-EU,SPAIN(CANARY ISLANDS),GATWICK,TENERIFE (SURREINA SOFIA),63368,51498,11870,19337,13993,5344,227.703367
15/02/2023 17:21,202212,WESTERN EUROPE-EU,SPAIN(CANARY ISLANDS),HEATHROW,ARRECIFE,0,0,0,4164,4164,0,-100
15/02/2023 17:21,202212,WESTERN EUROPE-EU,SPAIN(CANARY ISLANDS),HEATHROW,LAS PALMAS,0,0,0,1757,1757,0,-100
15/02/2023 17:21,202212,WESTERN EUROPE-EU,SPAIN(CANARY ISLANDS),HEATHROW,TENERIFE (SURREINA SOFIA),3619,3619,0,10931,10931,0,-66.892325
15/02/2023 17:21,202212,WESTERN EUROPE-EU,SPAIN(CANARY ISLANDS),LUTON,ARRECIFE,10287,7939,2348,3736,3076,660,175.347966
15/02/2023 17:21,202212,WESTERN EUROPE-EU,SPAIN(CANARY ISLANDS),LUTON,FUERTEVENTURA,4622,4622,0,3080,3080,0,50.064935
15/02/2023 17:21,202212,WESTERN EUROPE-EU,SPAIN(CANARY ISLANDS),LUTON,LAS PALMAS,5055,5055,0,3283,3283,0,53.975023
15/02/2023 17:21,202212,WESTERN EUROPE-EU,SPAIN(CANARY ISLANDS),LUTON,TENERIFE (SURREINA SOFIA),19245,17076,2169,10793,9575,1218,78.310016
15/02/2023 17:21,202212,WESTERN EUROPE-EU,SPAIN(CANARY ISLANDS),STANSTED,ARRECIFE,20305,20305,0,9781,9781,0,107.59636
15/02/2023 17:21,202212,WESTERN EUROPE-EU,SPAIN(CANARY ISLANDS),STANSTED,FUERTEVENTURA,14324,14324,0,4675,4675,0,206.395722
15/02/2023 17:21,202212,WESTERN EUROPE-EU,SPAIN(CANARY ISLANDS),STANSTED,LAS PALMAS,15487,14226,1261,7936,6768,1168,95.14869
15/02/2023 17:21,202212,WESTERN EUROPE-EU,SPAIN(CANARY ISLANDS),STANSTED,TENERIFE (SURREINA SOFIA),35986,33858,2128,17882,16242,1640,101.241472
15/02/2023 17:21,202212,WESTERN EUROPE-EU,SPAIN(CANARY ISLANDS),ABERDEEN,TENERIFE (SURREINA SOFIA),3131,0,3131,1977,0,1977,58.37127
15/02/2023 17:21,202212,WESTERN EUROPE-EU,SPAIN(CANARY ISLANDS),BELFAST INTERNATIONAL,ARRECIFE,7734,7734,0,4424,4424,0,74.819168
15/02/2023 17:21,202212,WESTERN EUROPE-EU,SPAIN(CANARY ISLANDS),BELFAST INTERNATIONAL,FUERTEVENTURA,2914,2914,0,974,974,0,199.178645
15/02/2023 17:21,202212,WESTERN EUROPE-EU,SPAIN(CANARY ISLANDS),BELFAST INTERNATIONAL,LAS PALMAS,5454,5454,0,2392,2392,0,128.010033
15/02/2023 17:21,202212,WESTERN EUROPE-EU,SPAIN(CANARY ISLANDS),BELFAST INTERNATIONAL,TENERIFE (SURREINA SOFIA),10742,10742,0,6559,6559,0,63.774966
15/02/2023 17:21,202212,WESTERN EUROPE-EU,SPAIN(CANARY ISLANDS),BIRMINGHAM,ARRECIFE,18771,14691,4080,10303,8043,2260,82.189653
15/02/2023 17:21,202212,WESTERN EUROPE-EU,SPAIN(CANARY ISLANDS),BIRMINGHAM,FUERTEVENTURA,13487,10634,2853,6092,4335,1757,121.388707
15/02/2023 17:21,202212,WESTERN EUROPE-EU,SPAIN(CANARY ISLANDS),BIRMINGHAM,LAS PALMAS,13407,8906,4501,7033,4206,2827,90.629888
15/02/2023 17:21,202212,WESTERN EUROPE-EU,SPAIN(CANARY ISLANDS),BIRMINGHAM,TENERIFE (SURREINA SOFIA),33530,25186,8344,15719,12527,3192,113.308735
15/02/2023 17:21,202212,WESTERN EUROPE-EU,SPAIN(CANARY ISLANDS),BOURNEMOUTH,ARRECIFE,3713,620,3093,1549,0,1549,139.703034
15/02/2023 17:21,202212,WESTERN EUROPE-EU,SPAIN(CANARY ISLANDS),BOURNEMOUTH,LAS PALMAS,1351,0,1351,1183,407,776,14.201183
15/02/2023 17:21,202212,WESTERN EUROPE-EU,SPAIN(CANARY ISLANDS),BOURNEMOUTH,TENERIFE (SURREINA SOFIA),4812,1594,3218,2987,1224,1763,61.098092
15/02/2023 17:21,202212,WESTERN EUROPE-EU,SPAIN(CANARY ISLANDS),BRISTOL,ARRECIFE,15531,14063,1468,7232,5952,1280,114.753872
15/02/2023 17:21,202212,WESTERN EUROPE-EU,SPAIN(CANARY ISLANDS),BRISTOL,FUERTEVENTURA,7198,5266,1932,3584,2278,1306,100.837054
15/02/2023 17:21,202212,WESTERN EUROPE-EU,SPAIN(CANARY ISLANDS),BRISTOL,LAS PALMAS,8433,6745,1688,4587,3107,1480,83.845651
15/02/2023 17:21,202212,WESTERN EUROPE-EU,SPAIN(CANARY ISLANDS),BRISTOL,TENERIFE (SURREINA SOFIA),28112,24440,3672,12213,10286,1927,130.180955
15/02/2023 17:21,202212,WESTERN EUROPE-EU,SPAIN(CANARY ISLANDS),CARDIFF WALES,ARRECIFE,3089,0,3089,1277,0,1277,141.895067
15/02/2023 17:21,202212,WESTERN EUROPE-EU,SPAIN(CANARY ISLANDS),CARDIFF WALES,LAS PALMAS,1573,0,1573,692,0,692,127.312139
15/02/2023 17:21,202212,WESTERN EUROPE-EU,SPAIN(CANARY ISLANDS),CARDIFF WALES,TENERIFE (SURREINA SOFIA),4498,0,4498,2339,0,2339,92.304404
15/02/2023 17:21,202212,WESTERN EUROPE-EU,SPAIN(CANARY ISLANDS),DONCASTER SHEFFIELD,ARRECIFE,0,0,0,2889,290,2599,-100
15/02/2023 17:21,202212,WESTERN EUROPE-EU,SPAIN(CANARY ISLANDS),DONCASTER SHEFFIELD,LAS PALMAS,0,0,0,821,0,821,-100
15/02/2023 17:21,202212,WESTERN EUROPE-EU,SPAIN(CANARY ISLANDS),DONCASTER SHEFFIELD,TENERIFE (SURREINA SOFIA),0,0,0,4853,1478,3375,-100
15/02/2023 17:21,202212,WESTERN EUROPE-EU,SPAIN(CANARY ISLANDS),EAST MIDLANDS INTERNATIONAL,ARRECIFE,17679,14616,3063,7358,6057,1301,140.269095
15/02/2023 17:21,202212,WESTERN EUROPE-EU,SPAIN(CANARY ISLANDS),EAST MIDLANDS INTERNATIONAL,FUERTEVENTURA,7734,7734,0,2884,2884,0,168.169209
15/02/2023 17:21,202212,WESTERN EUROPE-EU,SPAIN(CANARY ISLANDS),EAST MIDLANDS INTERNATIONAL,LAS PALMAS,5672,5672,0,3029,3029,0,87.25652
15/02/2023 17:21,202212,WESTERN EUROPE-EU,SPAIN(CANARY ISLANDS),EAST MIDLANDS INTERNATIONAL,TENERIFE (SURREINA SOFIA),25115,20622,4493,11602,9101,2501,116.471298
15/02/2023 17:21,202212,WESTERN EUROPE-EU,SPAIN(CANARY ISLANDS),EDINBURGH,ARRECIFE,13591,13591,0,5690,5690,0,138.857645
15/02/2023 17:21,202212,WESTERN EUROPE-EU,SPAIN(CANARY ISLANDS),EDINBURGH,FUERTEVENTURA,9784,9784,0,3477,3477,0,181.392005
15/02/2023 17:21,202212,WESTERN EUROPE-EU,SPAIN(CANARY ISLANDS),EDINBURGH,LAS PALMAS,6139,6139,0,2854,2854,0,115.101612
15/02/2023 17:21,202212,WESTERN EUROPE-EU,SPAIN(CANARY ISLANDS),EDINBURGH,TENERIFE (SURREINA SOFIA),23954,21824,2130,12553,10859,1694,90.822911
15/02/2023 17:21,202212,WESTERN EUROPE-EU,SPAIN(CANARY ISLANDS),EXETER,ARRECIFE,3121,185,2936,1481,0,1481,110.735989
15/02/2023 17:21,202212,WESTERN EUROPE-EU,SPAIN(CANARY ISLANDS),EXETER,LAS PALMAS,1280,0,1280,670,0,670,91.044776
15/02/2023 17:21,202212,WESTERN EUROPE-EU,SPAIN(CANARY ISLANDS),EXETER,TENERIFE (SURREINA SOFIA),3188,0,3188,1815,0,1815,75.647383
15/02/2023 17:21,202212,WESTERN EUROPE-EU,SPAIN(CANARY ISLANDS),GLASGOW,ARRECIFE,10825,8025,2800,5976,4290,1686,81.141232
15/02/2023 17:21,202212,WESTERN EUROPE-EU,SPAIN(CANARY ISLANDS),GLASGOW,FUERTEVENTURA,3657,3657,0,1984,1984,0,84.324597
15/02/2023 17:21,202212,WESTERN EUROPE-EU,SPAIN(CANARY ISLANDS),GLASGOW,LAS PALMAS,10425,8362,2063,4879,4154,725,113.670834
15/02/2023 17:21,202212,WESTERN EUROPE-EU,SPAIN(CANARY ISLANDS),GLASGOW,TENERIFE (SURREINA SOFIA),22611,18460,4151,12932,10787,2145,74.845345
15/02/2023 17:21,202212,WESTERN EUROPE-EU,SPAIN(CANARY ISLANDS),JERSEY,TENERIFE (SURREINA SOFIA),393,0,393,198,0,198,98.484848
15/02/2023 17:21,202212,WESTERN EUROPE-EU,SPAIN(CANARY ISLANDS),LEEDS BRADFORD,ARRECIFE,12316,12316,0,6492,6492,0,89.710413
15/02/2023 17:21,202212,WESTERN EUROPE-EU,SPAIN(CANARY ISLANDS),LEEDS BRADFORD,FUERTEVENTURA,7370,7370,0,1853,1853,0,297.733405
15/02/2023 17:21,202212,WESTERN EUROPE-EU,SPAIN(CANARY ISLANDS),LEEDS BRADFORD,LAS PALMAS,5743,5743,0,2619,2619,0,119.282169
15/02/2023 17:21,202212,WESTERN EUROPE-EU,SPAIN(CANARY ISLANDS),LEEDS BRADFORD,TENERIFE (SURREINA SOFIA),17546,17546,0,10165,10165,0,72.611904
15/02/2023 17:21,202212,WESTERN EUROPE-EU,SPAIN(CANARY ISLANDS),LIVERPOOL (JOHN LENNON),ARRECIFE,7958,7958,0,2701,2701,0,194.631618
15/02/2023 17:21,202212,WESTERN EUROPE-EU,SPAIN(CANARY ISLANDS),LIVERPOOL (JOHN LENNON),FUERTEVENTURA,2304,2304,0,684,684,0,236.842105
15/02/2023 17:21,202212,WESTERN EUROPE-EU,SPAIN(CANARY ISLANDS),LIVERPOOL (JOHN LENNON),TENERIFE (SURREINA SOFIA),9006,9006,0,3075,3075,0,192.878049
15/02/2023 17:21,202212,WESTERN EUROPE-EU,SPAIN(CANARY ISLANDS),MANCHESTER,ARRECIFE,40648,32673,7975,19575,15970,3605,107.652618
15/02/2023 17:21,202212,WESTERN EUROPE-EU,SPAIN(CANARY ISLANDS),MANCHESTER,FUERTEVENTURA,20842,17373,3469,10787,8196,2591,93.214054
15/02/2023 17:21,202212,WESTERN EUROPE-EU,SPAIN(CANARY ISLANDS),MANCHESTER,LAS PALMAS,20334,15846,4488,11677,8202,3475,74.137193
15/02/2023 17:21,202212,WESTERN EUROPE-EU,SPAIN(CANARY ISLANDS),MANCHESTER,SANTA CRUZ DE LA PALMA,1231,0,1231,0,0,0,0
15/02/2023 17:21,202212,WESTERN EUROPE-EU,SPAIN(CANARY ISLANDS),MANCHESTER,TENERIFE (SURREINA SOFIA),74954,59033,15921,38911,32476,6435,92.629334
15/02/2023 17:21,202212,WESTERN EUROPE-EU,SPAIN(CANARY ISLANDS),NEWCASTLE,ARRECIFE,12498,12498,0,6120,6120,0,104.215686
15/02/2023 17:21,202212,WESTERN EUROPE-EU,SPAIN(CANARY ISLANDS),NEWCASTLE,FUERTEVENTURA,5899,5899,0,2194,2194,0,168.869644
15/02/2023 17:21,202212,WESTERN EUROPE-EU,SPAIN(CANARY ISLANDS),NEWCASTLE,LAS PALMAS,8191,8191,0,3132,3132,0,161.526181
15/02/2023 17:21,202212,WESTERN EUROPE-EU,SPAIN(CANARY ISLANDS),NEWCASTLE,TENERIFE (SURREINA SOFIA),22440,22440,0,11176,11176,0,100.787402
15/02/2023 17:21,202212,WESTERN EUROPE-EU,SPAIN(CANARY ISLANDS),NORWICH,TENERIFE (SURREINA SOFIA),2871,0,2871,1277,0,1277,124.823806
15/02/2023 17:21,202212,WESTERN EUROPE-EU,SPAIN(CANARY ISLANDS),PRESTWICK,ARRECIFE,1851,1851,0,593,593,0,212.141653
15/02/2023 17:21,202212,WESTERN EUROPE-EU,SPAIN(CANARY ISLANDS),PRESTWICK,LAS PALMAS,2023,2023,0,0,0,0,0
15/02/2023 17:21,202212,WESTERN EUROPE-EU,SPAIN(CANARY ISLANDS),PRESTWICK,TENERIFE (SURREINA SOFIA),5631,5631,0,1849,1849,0,204.542996
15/02/2023 17:21,202212,WESTERN EUROPE-EU,SWEDEN,GATWICK,PAJALA YLLAS,374,0,374,178,0,178,110.11236
15/02/2023 17:21,202212,WESTERN EUROPE-EU,SWEDEN,GATWICK,STOCKHOLM (ARLANDA),29004,29004,0,8511,8511,0,240.782517
15/02/2023 17:21,202212,WESTERN EUROPE-EU,SWEDEN,HEATHROW,GOTEBORG (LANDVETTER),16484,16484,0,7365,7365,0,123.815343
15/02/2023 17:21,202212,WESTERN EUROPE-EU,SWEDEN,HEATHROW,LULEA,1248,1248,0,0,0,0,0
15/02/2023 17:21,202212,WESTERN EUROPE-EU,SWEDEN,HEATHROW,STOCKHOLM (ARLANDA),64060,64060,0,27201,27201,0,135.506048
15/02/2023 17:21,202212,WESTERN EUROPE-EU,SWEDEN,STANSTED,GOTEBORG (LANDVETTER),11612,11612,0,5095,5095,0,127.909715
15/02/2023 17:21,202212,WESTERN EUROPE-EU,SWEDEN,STANSTED,OREBRO,2298,2298,0,0,0,0,0
15/02/2023 17:21,202212,WESTERN EUROPE-EU,SWEDEN,STANSTED,STOCKHOLM (ARLANDA),20203,20203,0,8031,8031,0,151.562695
15/02/2023 17:21,202212,WESTERN EUROPE-EU,SWEDEN,STANSTED,VASTERAS,4128,4128,0,4350,4350,0,-5.103448
15/02/2023 17:21,202212,WESTERN EUROPE-EU,SWEDEN,STANSTED,VAXJO,1980,1980,0,0,0,0,0
15/02/2023 17:21,202212,WESTERN EUROPE-EU,SWEDEN,BELFAST INTERNATIONAL,PAJALA YLLAS,375,0,375,0,0,0,0
15/02/2023 17:21,202212,WESTERN EUROPE-EU,SWEDEN,BELFAST INTERNATIONAL,STOCKHOLM (ARLANDA),13,0,13,0,0,0,0
15/02/2023 17:21,202212,WESTERN EUROPE-EU,SWEDEN,BIRMINGHAM,PAJALA YLLAS,367,0,367,368,0,368,-0.271739
15/02/2023 17:21,202212,WESTERN EUROPE-EU,SWEDEN,BIRMINGHAM,STOCKHOLM (ARLANDA),2298,2298,0,0,0,0,0
15/02/2023 17:21,202212,WESTERN EUROPE-EU,SWEDEN,BOURNEMOUTH,PAJALA YLLAS,358,0,358,351,0,351,1.994302
15/02/2023 17:21,202212,WESTERN EUROPE-EU,SWEDEN,CARDIFF WALES,PAJALA YLLAS,366,0,366,360,0,360,1.666667
15/02/2023 17:21,202212,WESTERN EUROPE-EU,SWEDEN,EAST MIDLANDS INTERNATIONAL,PAJALA YLLAS,0,0,0,170,0,170,-100
15/02/2023 17:21,202212,WESTERN EUROPE-EU,SWEDEN,EDINBURGH,GOTEBORG (LANDVETTER),2647,2647,0,1280,1280,0,106.796875
15/02/2023 17:21,202212,WESTERN EUROPE-EU,SWEDEN,EDINBURGH,STOCKHOLM (ARLANDA),4641,4641,0,2073,2073,0,123.878437
15/02/2023 17:21,202212,WESTERN EUROPE-EU,SWEDEN,EXETER,PAJALA YLLAS,358,0,358,336,0,336,6.547619
15/02/2023 17:21,202212,WESTERN EUROPE-EU,SWEDEN,GLASGOW,PAJALA YLLAS,374,0,374,336,0,336,11.309524
15/02/2023 17:21,202212,WESTERN EUROPE-EU,SWEDEN,HUMBERSIDE,PAJALA YLLAS,748,0,748,720,0,720,3.888889
15/02/2023 17:21,202212,WESTERN EUROPE-EU,SWEDEN,LEEDS BRADFORD,PAJALA YLLAS,376,0,376,170,170,0,121.176471
15/02/2023 17:21,202212,WESTERN EUROPE-EU,SWEDEN,LIVERPOOL (JOHN LENNON),PAJALA YLLAS,376,0,376,360,0,360,4.444444
15/02/2023 17:21,202212,WESTERN EUROPE-EU,SWEDEN,LIVERPOOL (JOHN LENNON),STOCKHOLM (ARLANDA),2599,2599,0,1265,1265,0,105.454545
15/02/2023 17:21,202212,WESTERN EUROPE-EU,SWEDEN,MANCHESTER,GOTEBORG (LANDVETTER),3244,3244,0,2028,2028,0,59.960552
15/02/2023 17:21,202212,WESTERN EUROPE-EU,SWEDEN,MANCHESTER,STOCKHOLM (ARLANDA),7684,7684,0,3055,3055,0,151.522095
15/02/2023 17:21,202212,WESTERN EUROPE-EU,SWEDEN,NORWICH,PAJALA YLLAS,376,0,376,179,0,179,110.055866
15/02/2023 17:21,202212,WESTERN EUROPE-EU,SWEDEN,TEESSIDE INTERNATIONAL AIRPORT,PAJALA YLLAS,374,0,374,0,0,0,0
15/02/2023 17:21,202212,WESTERN EUROPE-OTHER,BOSNIA-HERZEGOVINA,GATWICK,SARAJEVO,182,0,182,0,0,0,0
15/02/2023 17:21,202212,WESTERN EUROPE-OTHER,BOSNIA-HERZEGOVINA,LUTON,SARAJEVO,2375,2375,0,0,0,0,0
15/02/2023 17:21,202212,WESTERN EUROPE-OTHER,FAROE ISLANDS,EDINBURGH,VAGAR,934,934,0,332,332,0,181.325301
15/02/2023 17:21,202212,WESTERN EUROPE-OTHER,ICELAND,GATWICK,KEFLAVIK,20230,18956,1274,8374,7657,717,141.581084
15/02/2023 17:21,202212,WESTERN EUROPE-OTHER,ICELAND,HEATHROW,KEFLAVIK,24579,24579,0,16083,16083,0,52.825965
15/02/2023 17:21,202212,WESTERN EUROPE-OTHER,ICELAND,LUTON,KEFLAVIK,14164,14164,0,9409,9409,0,50.53672
15/02/2023 17:21,202212,WESTERN EUROPE-OTHER,ICELAND,STANSTED,KEFLAVIK,8838,8838,0,2772,2772,0,218.831169
15/02/2023 17:21,202212,WESTERN EUROPE-OTHER,ICELAND,BIGGIN HILL,KEFLAVIK,8,0,8,0,0,0,0
15/02/2023 17:21,202212,WESTERN EUROPE-OTHER,ICELAND,BRISTOL,KEFLAVIK,4884,4884,0,2203,2203,0,121.697685
15/02/2023 17:21,202212,WESTERN EUROPE-OTHER,ICELAND,EDINBURGH,KEFLAVIK,4803,4803,0,1533,1533,0,213.307241
15/02/2023 17:21,202212,WESTERN EUROPE-OTHER,ICELAND,GLASGOW,KEFLAVIK,5358,5358,0,0,0,0,0
15/02/2023 17:21,202212,WESTERN EUROPE-OTHER,ICELAND,LIVERPOOL (JOHN LENNON),KEFLAVIK,2034,2034,0,0,0,0,0
15/02/2023 17:21,202212,WESTERN EUROPE-OTHER,ICELAND,MANCHESTER,KEFLAVIK,20747,19518,1229,11486,10818,668,80.628591
15/02/2023 17:21,202212,WESTERN EUROPE-OTHER,KOSOVO,LUTON,PRISTINA,9897,9897,0,7980,7980,0,24.022556
15/02/2023 17:21,202212,WESTERN EUROPE-OTHER,KOSOVO,PRESTWICK,PRISTINA,189,0,189,0,0,0,0
15/02/2023 17:21,202212,WESTERN EUROPE-OTHER,MACEDONIA,LUTON,SKOPJE,5487,5487,0,3921,3921,0,39.938791
15/02/2023 17:21,202212,WESTERN EUROPE-OTHER,NORWAY,GATWICK,BERGEN,16080,15934,146,3941,3941,0,308.018269
15/02/2023 17:21,202212,WESTERN EUROPE-OTHER,NORWAY,GATWICK,OSLO (GARDERMOEN),33597,33597,0,8177,8177,0,310.871958
15/02/2023 17:21,202212,WESTERN EUROPE-OTHER,NORWAY,GATWICK,STAVANGER,8355,8355,0,2483,2483,0,236.488119
15/02/2023 17:21,202212,WESTERN EUROPE-OTHER,NORWAY,GATWICK,TROMSOE,2834,2834,0,1300,1300,0,118
15/02/2023 17:21,202212,WESTERN EUROPE-OTHER,NORWAY,GATWICK,TRONDHEIM (VAERNES),2293,2293,0,1109,1109,0,106.762849
15/02/2023 17:21,202212,WESTERN EUROPE-OTHER,NORWAY,HEATHROW,BERGEN,2629,2629,0,2973,2973,0,-11.570804
15/02/2023 17:21,202212,WESTERN EUROPE-OTHER,NORWAY,HEATHROW,OSLO (GARDERMOEN),49382,49382,0,15571,15571,0,217.140839
15/02/2023 17:21,202212,WESTERN EUROPE-OTHER,NORWAY,HEATHROW,STAVANGER,3870,3870,0,0,0,0,0
15/02/2023 17:21,202212,WESTERN EUROPE-OTHER,NORWAY,LUTON,TROMSOE,2234,2234,0,0,0,0,0
15/02/2023 17:21,202212,WESTERN EUROPE-OTHER,NORWAY,STANSTED,BERGEN,936,936,0,0,0,0,0
15/02/2023 17:21,202212,WESTERN EUROPE-OTHER,NORWAY,STANSTED,OSLO (GARDERMOEN),13302,13302,0,10992,10992,0,21.015284
15/02/2023 17:21,202212,WESTERN EUROPE-OTHER,NORWAY,STANSTED,SANDEFJORD(TORP),4870,4870,0,1487,1487,0,227.505044
15/02/2023 17:21,202212,WESTERN EUROPE-OTHER,NORWAY,ABERDEEN,BERGEN,2991,2991,0,1827,1827,0,63.711002
15/02/2023 17:21,202212,WESTERN EUROPE-OTHER,NORWAY,ABERDEEN,HAUGESUND,0,0,0,44,44,0,-100
15/02/2023 17:21,202212,WESTERN EUROPE-OTHER,NORWAY,ABERDEEN,OSLO (GARDERMOEN),512,512,0,0,0,0,0
15/02/2023 17:21,202212,WESTERN EUROPE-OTHER,NORWAY,ABERDEEN,STAVANGER,4747,4747,0,2120,2120,0,123.915094
15/02/2023 17:21,202212,WESTERN EUROPE-OTHER,NORWAY,BIGGIN HILL,SANDEFJORD(TORP),20,0,20,0,0,0,0
15/02/2023 17:21,202212,WESTERN EUROPE-OTHER,NORWAY,BIRMINGHAM,BERGEN,0,0,0,167,0,167,-100
15/02/2023 17:21,202212,WESTERN EUROPE-OTHER,NORWAY,EDINBURGH,BERGEN,459,459,0,0,0,0,0
15/02/2023 17:21,202212,WESTERN EUROPE-OTHER,NORWAY,EDINBURGH,OSLO (GARDERMOEN),8619,8619,0,3359,3359,0,156.594224
15/02/2023 17:21,202212,WESTERN EUROPE-OTHER,NORWAY,EDINBURGH,STAVANGER,318,318,0,0,0,0,0
15/02/2023 17:21,202212,WESTERN EUROPE-OTHER,NORWAY,GLASGOW,SANDEFJORD(TORP),0,0,0,102,102,0,-100
15/02/2023 17:21,202212,WESTERN EUROPE-OTHER,NORWAY,MANCHESTER,BERGEN,471,471,0,298,298,0,58.053691
15/02/2023 17:21,202212,WESTERN EUROPE-OTHER,NORWAY,MANCHESTER,OSLO (GARDERMOEN),8851,8851,0,4808,4808,0,84.089018
15/02/2023 17:21,202212,WESTERN EUROPE-OTHER,NORWAY,MANCHESTER,SANDEFJORD(TORP),5456,5456,0,2827,2827,0,92.996109
15/02/2023 17:21,202212,WESTERN EUROPE-OTHER,NORWAY,MANCHESTER,STAVANGER,503,503,0,0,0,0,0
15/02/2023 17:21,202212,WESTERN EUROPE-OTHER,NORWAY,MANCHESTER,TRONDHEIM (VAERNES),483,483,0,0,0,0,0
15/02/2023 17:21,202212,WESTERN EUROPE-OTHER,NORWAY,NEWCASTLE,BERGEN,112,112,0,101,101,0,10.891089
15/02/2023 17:21,202212,WESTERN EUROPE-OTHER,NORWAY,NEWCASTLE,STAVANGER,585,585,0,0,0,0,0
15/02/2023 17:21,202212,WESTERN EUROPE-OTHER,REPUBLIC OF MONTENEGRO,STANSTED,PODGORICA,4787,4787,0,1826,1826,0,162.157722
15/02/2023 17:21,202212,WESTERN EUROPE-OTHER,REPUBLIC OF MONTENEGRO,MANCHESTER,PODGORICA,1929,1929,0,0,0,0,0
15/02/2023 17:21,202212,WESTERN EUROPE-OTHER,REPUBLIC OF SERBIA,HEATHROW,BELGRADE,6006,6006,0,2443,2443,0,145.845272
15/02/2023 17:21,202212,WESTERN EUROPE-OTHER,REPUBLIC OF SERBIA,LUTON,BELGRADE,7874,7874,0,4282,4282,0,83.886035
15/02/2023 17:21,202212,WESTERN EUROPE-OTHER,SWITZERLAND,GATWICK,BALE MULHOUSE,21167,21167,0,6407,6407,0,230.373029
15/02/2023 17:21,202212,WESTERN EUROPE-OTHER,SWITZERLAND,GATWICK,GENEVA,81367,80814,553,20236,20236,0,302.090334
15/02/2023 17:21,202212,WESTERN EUROPE-OTHER,SWITZERLAND,GATWICK,ZURICH,15842,15842,0,4152,4152,0,281.55106
15/02/2023 17:21,202212,WESTERN EUROPE-OTHER,SWITZERLAND,HEATHROW,BALE MULHOUSE,22843,22843,0,0,0,0,0
15/02/2023 17:21,202212,WESTERN EUROPE-OTHER,SWITZERLAND,HEATHROW,GENEVA,91679,91679,0,34424,34424,0,166.322914
15/02/2023 17:21,202212,WESTERN EUROPE-OTHER,SWITZERLAND,HEATHROW,ZURICH,96423,96423,0,33078,33078,0,191.501905
15/02/2023 17:21,202212,WESTERN EUROPE-OTHER,SWITZERLAND,LONDON CITY,GENEVA,8269,8269,0,910,910,0,808.681319
15/02/2023 17:21,202212,WESTERN EUROPE-OTHER,SWITZERLAND,LONDON CITY,ZURICH,26324,26324,0,8438,8438,0,211.969661
15/02/2023 17:21,202212,WESTERN EUROPE-OTHER,SWITZERLAND,LUTON,GENEVA,46037,46037,0,9464,9464,0,386.443364
15/02/2023 17:21,202212,WESTERN EUROPE-OTHER,SWITZERLAND,LUTON,ZURICH,4887,4887,0,2903,2903,0,68.343093
15/02/2023 17:21,202212,WESTERN EUROPE-OTHER,SWITZERLAND,STANSTED,GENEVA,2937,2937,0,654,654,0,349.082569
15/02/2023 17:21,202212,WESTERN EUROPE-OTHER,SWITZERLAND,STANSTED,ZURICH,163,163,0,0,0,0,0
15/02/2023 17:21,202212,WESTERN EUROPE-OTHER,SWITZERLAND,ABERDEEN,GENEVA,732,732,0,14,14,0,5128.571429
15/02/2023 17:21,202212,WESTERN EUROPE-OTHER,SWITZERLAND,BELFAST INTERNATIONAL,GENEVA,2693,2693,0,420,420,0,541.190476
15/02/2023 17:21,202212,WESTERN EUROPE-OTHER,SWITZERLAND,BIGGIN HILL,BERNE,0,0,0,8,0,8,-100
15/02/2023 17:21,202212,WESTERN EUROPE-OTHER,SWITZERLAND,BIGGIN HILL,GENEVA,4,0,4,1,0,1,300
15/02/2023 17:21,202212,WESTERN EUROPE-OTHER,SWITZERLAND,BIGGIN HILL,SION,8,0,8,15,0,15,-46.666667
15/02/2023 17:21,202212,WESTERN EUROPE-OTHER,SWITZERLAND,BIGGIN HILL,ZURICH,15,0,15,19,0,19,-21.052632
15/02/2023 17:21,202212,WESTERN EUROPE-OTHER,SWITZERLAND,BIRMINGHAM,GENEVA,14912,14912,0,4049,4049,0,268.288466
15/02/2023 17:21,202212,WESTERN EUROPE-OTHER,SWITZERLAND,BIRMINGHAM,ZURICH,3704,3704,0,973,973,0,280.678314
15/02/2023 17:21,202212,WESTERN EUROPE-OTHER,SWITZERLAND,BOURNEMOUTH,GENEVA,4260,4260,0,720,720,0,491.666667
15/02/2023 17:21,202212,WESTERN EUROPE-OTHER,SWITZERLAND,BRISTOL,BALE MULHOUSE,4674,4674,0,612,612,0,663.72549
15/02/2023 17:21,202212,WESTERN EUROPE-OTHER,SWITZERLAND,BRISTOL,GENEVA,26018,25095,923,5817,5817,0,347.275228
15/02/2023 17:21,202212,WESTERN EUROPE-OTHER,SWITZERLAND,EAST MIDLANDS INTERNATIONAL,GENEVA,658,658,0,0,0,0,0
15/02/2023 17:21,202212,WESTERN EUROPE-OTHER,SWITZERLAND,EDINBURGH,BALE MULHOUSE,5455,5455,0,1416,1416,0,285.240113
15/02/2023 17:21,202212,WESTERN EUROPE-OTHER,SWITZERLAND,EDINBURGH,GENEVA,14809,14809,0,3204,3204,0,362.203496
15/02/2023 17:21,202212,WESTERN EUROPE-OTHER,SWITZERLAND,EDINBURGH,ZURICH,1899,1899,0,452,452,0,320.132743
15/02/2023 17:21,202212,WESTERN EUROPE-OTHER,SWITZERLAND,GLASGOW,GENEVA,1749,1749,0,237,237,0,637.974684
15/02/2023 17:21,202212,WESTERN EUROPE-OTHER,SWITZERLAND,LEEDS BRADFORD,GENEVA,2312,2312,0,446,446,0,418.38565
15/02/2023 17:21,202212,WESTERN EUROPE-OTHER,SWITZERLAND,LIVERPOOL (JOHN LENNON),GENEVA,11854,11854,0,1601,1601,0,640.412242
15/02/2023 17:21,202212,WESTERN EUROPE-OTHER,SWITZERLAND,LIVERPOOL (JOHN LENNON),SION,19,0,19,0,0,0,0
15/02/2023 17:21,202212,WESTERN EUROPE-OTHER,SWITZERLAND,MANCHESTER,BALE MULHOUSE,6672,6672,0,1863,1863,0,258.132045
15/02/2023 17:21,202212,WESTERN EUROPE-OTHER,SWITZERLAND,MANCHESTER,BERNE,0,0,0,144,0,144,-100
15/02/2023 17:21,202212,WESTERN EUROPE-OTHER,SWITZERLAND,MANCHESTER,GENEVA,27300,26760,540,9243,9243,0,195.35865
15/02/2023 17:21,202212,WESTERN EUROPE-OTHER,SWITZERLAND,MANCHESTER,ZURICH,11354,11354,0,3706,3706,0,206.368052
15/02/2023 17:21,202212,WESTERN EUROPE-OTHER,SWITZERLAND,NEWCASTLE,GENEVA,2698,2698,0,108,108,0,2398.148148
15/02/2023 17:21,202212,WESTERN EUROPE-OTHER,SWITZERLAND,SOUTHAMPTON,GENEVA,2799,2799,0,325,325,0,761.230769
15/02/2023 17:21,202212,WESTERN EUROPE-OTHER,TURKEY,GATWICK,ANTALYA,9603,9483,120,3885,3885,0,147.181467
15/02/2023 17:21,202212,WESTERN EUROPE-OTHER,TURKEY,GATWICK,DALAMAN,2712,2712,0,0,0,0,0
15/02/2023 17:21,202212,WESTERN EUROPE-OTHER,TURKEY,GATWICK,ISTANBUL,23845,23845,0,12822,12822,0,85.969428
15/02/2023 17:21,202212,WESTERN EUROPE-OTHER,TURKEY,HEATHROW,ISTANBUL,97264,97264,0,61572,61572,0,57.967907
15/02/2023 17:21,202212,WESTERN EUROPE-OTHER,TURKEY,LUTON,ANTALYA,10486,10316,170,2641,2641,0,297.046573
15/02/2023 17:21,202212,WESTERN EUROPE-OTHER,TURKEY,LUTON,DALAMAN,3694,3694,0,0,0,0,0
15/02/2023 17:21,202212,WESTERN EUROPE-OTHER,TURKEY,LUTON,GAZIANTEP,715,715,0,174,174,0,310.91954
15/02/2023 17:21,202212,WESTERN EUROPE-OTHER,TURKEY,LUTON,IZMIR (ADNAN MENDERES),544,544,0,381,381,0,42.782152
15/02/2023 17:21,202212,WESTERN EUROPE-OTHER,TURKEY,STANSTED,ANKARA (ESENBOGA),3988,3988,0,1002,1002,0,298.003992
15/02/2023 17:21,202212,WESTERN EUROPE-OTHER,TURKEY,STANSTED,ANTALYA,8531,8531,0,5549,5549,0,53.739413
15/02/2023 17:21,202212,WESTERN EUROPE-OTHER,TURKEY,STANSTED,ISTANBUL,746,746,0,0,0,0,0
15/02/2023 17:21,202212,WESTERN EUROPE-OTHER,TURKEY,STANSTED,ISTANBUL (SABIHA GOKCEN),65566,65566,0,49343,49343,0,32.878017
15/02/2023 17:21,202212,WESTERN EUROPE-OTHER,TURKEY,STANSTED,IZMIR (ADNAN MENDERES),9290,9290,0,5904,5904,0,57.350949
15/02/2023 17:21,202212,WESTERN EUROPE-OTHER,TURKEY,BIRMINGHAM,ANTALYA,5706,5706,0,2687,2687,0,112.355787
15/02/2023 17:21,202212,WESTERN EUROPE-OTHER,TURKEY,BIRMINGHAM,ISTANBUL,15309,15309,0,6655,6655,0,130.037566
15/02/2023 17:21,202212,WESTERN EUROPE-OTHER,TURKEY,BRISTOL,ANTALYA,1775,1775,0,1207,1207,0,47.058824
15/02/2023 17:21,202212,WESTERN EUROPE-OTHER,TURKEY,EDINBURGH,ANTALYA,2243,2243,0,1194,1194,0,87.855946
15/02/2023 17:21,202212,WESTERN EUROPE-OTHER,TURKEY,EDINBURGH,ISTANBUL,10110,10110,0,3721,3721,0,171.701156
15/02/2023 17:21,202212,WESTERN EUROPE-OTHER,TURKEY,GLASGOW,ANTALYA,1736,1736,0,1063,1063,0,63.311383
15/02/2023 17:21,202212,WESTERN EUROPE-OTHER,TURKEY,HUMBERSIDE,ANTALYA,367,0,367,0,0,0,0
15/02/2023 17:21,202212,WESTERN EUROPE-OTHER,TURKEY,LEEDS BRADFORD,ANTALYA,1259,1259,0,839,839,0,50.059595
15/02/2023 17:21,202212,WESTERN EUROPE-OTHER,TURKEY,LIVERPOOL (JOHN LENNON),ANTALYA,1550,1550,0,0,0,0,0
15/02/2023 17:21,202212,WESTERN EUROPE-OTHER,TURKEY,MANCHESTER,ANTALYA,14059,14059,0,7686,7686,0,82.916992
15/02/2023 17:21,202212,WESTERN EUROPE-OTHER,TURKEY,MANCHESTER,DALAMAN,2840,2840,0,0,0,0,0
15/02/2023 17:21,202212,WESTERN EUROPE-OTHER,TURKEY,MANCHESTER,ISTANBUL,29824,29824,0,20529,20529,0,45.277412
15/02/2023 17:21,202212,WESTERN EUROPE-OTHER,TURKEY,MANCHESTER,ISTANBUL (SABIHA GOKCEN),12226,12226,0,7860,7860,0,55.547074
15/02/2023 17:21,202212,WESTERN EUROPE-OTHER,TURKEY,MANCHESTER,IZMIR (ADNAN MENDERES),648,648,0,0,0,0,0
15/02/2023 17:21,202212,WESTERN EUROPE-OTHER,TURKEY,NEWCASTLE,ANTALYA,1684,1684,0,1002,1002,0,68.063872
15/02/2023 17:21,202212,EASTERN EUROPE-EU,BULGARIA,GATWICK,SOFIA,10867,10187,680,10160,9296,864,6.958661
15/02/2023 17:21,202212,EASTERN EUROPE-EU,BULGARIA,HEATHROW,SOFIA,7846,7846,0,4501,4501,0,74.316818
15/02/2023 17:21,202212,EASTERN EUROPE-EU,BULGARIA,LUTON,BURGAS,4204,4204,0,3353,3353,0,25.380256
15/02/2023 17:21,202212,EASTERN EUROPE-EU,BULGARIA,LUTON,PLOVDIV,4716,4716,0,3541,3541,0,33.182717
15/02/2023 17:21,202212,EASTERN EUROPE-EU,BULGARIA,LUTON,SOFIA,20491,20491,0,15675,15675,0,30.724083
15/02/2023 17:21,202212,EASTERN EUROPE-EU,BULGARIA,LUTON,VARNA,8303,8303,0,7699,7699,0,7.845175
15/02/2023 17:21,202212,EASTERN EUROPE-EU,BULGARIA,STANSTED,PLOVDIV,6803,6803,0,2920,2920,0,132.979452
15/02/2023 17:21,202212,EASTERN EUROPE-EU,BULGARIA,STANSTED,SOFIA,23909,23909,0,14766,14766,0,61.919274
15/02/2023 17:21,202212,EASTERN EUROPE-EU,BULGARIA,BELFAST INTERNATIONAL,PLOVDIV,492,0,492,567,0,567,-13.227513
15/02/2023 17:21,202212,EASTERN EUROPE-EU,BULGARIA,BELFAST INTERNATIONAL,SOFIA,115,0,115,189,0,189,-39.153439
15/02/2023 17:21,202212,EASTERN EUROPE-EU,BULGARIA,BIRMINGHAM,SOFIA,3838,3664,174,4351,3858,493,-11.790393
15/02/2023 17:21,202212,EASTERN EUROPE-EU,BULGARIA,BRISTOL,SOFIA,3937,3702,235,1433,1131,302,174.738311
15/02/2023 17:21,202212,EASTERN EUROPE-EU,BULGARIA,EAST MIDLANDS INTERNATIONAL,SOFIA,238,238,0,325,0,325,-26.769231
15/02/2023 17:21,202212,EASTERN EUROPE-EU,BULGARIA,EDINBURGH,SOFIA,2727,2727,0,2349,2349,0,16.091954
15/02/2023 17:21,202212,EASTERN EUROPE-EU,BULGARIA,LIVERPOOL (JOHN LENNON),SOFIA,2308,2308,0,734,734,0,214.441417
15/02/2023 17:21,202212,EASTERN EUROPE-EU,BULGARIA,LIVERPOOL (JOHN LENNON),VARNA,2510,2510,0,0,0,0,0
15/02/2023 17:21,202212,EASTERN EUROPE-EU,BULGARIA,MANCHESTER,SOFIA,8016,7352,664,5772,5045,727,38.877339
15/02/2023 17:21,202212,EASTERN EUROPE-EU,BULGARIA,NEWCASTLE,SOFIA,105,105,0,111,111,0,-5.405405
15/02/2023 17:21,202212,EASTERN EUROPE-EU,BULGARIA,NEWQUAY,SOFIA,0,0,0,147,0,147,-100
15/02/2023 17:21,202212,EASTERN EUROPE-EU,CZECH REPUBLIC,GATWICK,PRAGUE,11880,11880,0,4772,4772,0,148.952221
15/02/2023 17:21,202212,EASTERN EUROPE-EU,CZECH REPUBLIC,HEATHROW,PRAGUE,29376,29376,0,13076,13076,0,124.655858
15/02/2023 17:21,202212,EASTERN EUROPE-EU,CZECH REPUBLIC,LONDON CITY,PRAGUE,1784,1784,0,280,280,0,537.142857
15/02/2023 17:21,202212,EASTERN EUROPE-EU,CZECH REPUBLIC,LUTON,PRAGUE,10821,10821,0,0,0,0,0
15/02/2023 17:21,202212,EASTERN EUROPE-EU,CZECH REPUBLIC,STANSTED,BRNO (TURANY),7307,7307,0,3620,3620,0,101.850829
15/02/2023 17:21,202212,EASTERN EUROPE-EU,CZECH REPUBLIC,STANSTED,OSTRAVA,2508,2508,0,1640,1640,0,52.926829
15/02/2023 17:21,202212,EASTERN EUROPE-EU,CZECH REPUBLIC,STANSTED,PRAGUE,23950,23950,0,12787,12787,0,87.299601
15/02/2023 17:21,202212,EASTERN EUROPE-EU,CZECH REPUBLIC,BELFAST INTERNATIONAL,PRAGUE,1671,1671,0,564,564,0,196.276596
15/02/2023 17:21,202212,EASTERN EUROPE-EU,CZECH REPUBLIC,BIGGIN HILL,PRAGUE,6,0,6,0,0,0,0
15/02/2023 17:21,202212,EASTERN EUROPE-EU,CZECH REPUBLIC,BIRMINGHAM,PRAGUE,6604,6604,0,2047,2047,0,222.618466
15/02/2023 17:21,202212,EASTERN EUROPE-EU,CZECH REPUBLIC,BRISTOL,PRAGUE,6177,6177,0,2861,2861,0,115.90353
15/02/2023 17:21,202212,EASTERN EUROPE-EU,CZECH REPUBLIC,EAST MIDLANDS INTERNATIONAL,PRAGUE,1913,1913,0,554,554,0,245.306859
15/02/2023 17:21,202212,EASTERN EUROPE-EU,CZECH REPUBLIC,EDINBURGH,PRAGUE,4223,4223,0,2292,2292,0,84.249564
15/02/2023 17:21,202212,EASTERN EUROPE-EU,CZECH REPUBLIC,GLASGOW,PRAGUE,2996,2996,0,0,0,0,0
15/02/2023 17:21,202212,EASTERN EUROPE-EU,CZECH REPUBLIC,LEEDS BRADFORD,PRAGUE,2389,2389,0,1007,1007,0,137.239325
15/02/2023 17:21,202212,EASTERN EUROPE-EU,CZECH REPUBLIC,MANCHESTER,PRAGUE,22322,22322,0,7468,7468,0,198.901982
15/02/2023 17:21,202212,EASTERN EUROPE-EU,CZECH REPUBLIC,NEWCASTLE,PRAGUE,3042,3042,0,1194,1194,0,154.773869
15/02/2023 17:21,202212,EASTERN EUROPE-EU,ESTONIA,GATWICK,TALLIN,3125,3125,0,2287,2287,0,36.641889
15/02/2023 17:21,202212,EASTERN EUROPE-EU,ESTONIA,LUTON,TALLIN,4452,4452,0,0,0,0,0
15/02/2023 17:21,202212,EASTERN EUROPE-EU,ESTONIA,STANSTED,TALLIN,5699,5699,0,5075,5075,0,12.295567
15/02/2023 17:21,202212,EASTERN EUROPE-EU,ESTONIA,EDINBURGH,TALLIN,0,0,0,1405,1405,0,-100
15/02/2023 17:21,202212,EASTERN EUROPE-EU,ESTONIA,LIVERPOOL (JOHN LENNON),TALLIN,0,0,0,1422,1422,0,-100
15/02/2023 17:21,202212,EASTERN EUROPE-EU,HUNGARY,GATWICK,BUDAPEST,17796,17796,0,6668,6668,0,166.886623
15/02/2023 17:21,202212,EASTERN EUROPE-EU,HUNGARY,HEATHROW,BUDAPEST,18585,18585,0,8497,8497,0,118.724256
15/02/2023 17:21,202212,EASTERN EUROPE-EU,HUNGARY,LUTON,BUDAPEST,28270,28270,0,19068,19068,0,48.258863
15/02/2023 17:21,202212,EASTERN EUROPE-EU,HUNGARY,LUTON,DEBRECEN,7199,7199,0,3692,3692,0,94.989166
15/02/2023 17:21,202212,EASTERN EUROPE-EU,HUNGARY,STANSTED,BUDAPEST,40301,40301,0,21629,21629,0,86.32854
15/02/2023 17:21,202212,EASTERN EUROPE-EU,HUNGARY,BIGGIN HILL,BUDAPEST,0,0,0,2,0,2,-100
15/02/2023 17:21,202212,EASTERN EUROPE-EU,HUNGARY,BIRMINGHAM,BUDAPEST,7712,7712,0,1764,1764,0,337.188209
15/02/2023 17:21,202212,EASTERN EUROPE-EU,HUNGARY,BOURNEMOUTH,BUDAPEST,0,0,0,1633,1633,0,-100
15/02/2023 17:21,202212,EASTERN EUROPE-EU,HUNGARY,BRISTOL,BUDAPEST,4639,4639,0,3769,3769,0,23.083046
15/02/2023 17:21,202212,EASTERN EUROPE-EU,HUNGARY,EAST MIDLANDS INTERNATIONAL,BUDAPEST,4654,4654,0,2051,2051,0,126.913701
15/02/2023 17:21,202212,EASTERN EUROPE-EU,HUNGARY,EDINBURGH,BUDAPEST,11829,11829,0,5576,5576,0,112.14132
15/02/2023 17:21,202212,EASTERN EUROPE-EU,HUNGARY,LEEDS BRADFORD,BUDAPEST,2651,2651,0,1121,1121,0,136.485281
15/02/2023 17:21,202212,EASTERN EUROPE-EU,HUNGARY,LIVERPOOL (JOHN LENNON),BUDAPEST,2707,2707,0,732,732,0,269.808743
15/02/2023 17:21,202212,EASTERN EUROPE-EU,HUNGARY,MANCHESTER,BUDAPEST,12210,12210,0,7614,7614,0,60.36249
15/02/2023 17:21,202212,EASTERN EUROPE-EU,HUNGARY,NEWCASTLE,BUDAPEST,1175,1175,0,784,784,0,49.872449
15/02/2023 17:21,202212,EASTERN EUROPE-EU,LATVIA,GATWICK,RIGA,8918,8918,0,4075,4075,0,118.846626
15/02/2023 17:21,202212,EASTERN EUROPE-EU,LATVIA,LUTON,RIGA,9227,9227,0,5885,5885,0,56.788445
15/02/2023 17:21,202212,EASTERN EUROPE-EU,LATVIA,STANSTED,RIGA,21043,21043,0,9742,9742,0,116.002874
15/02/2023 17:21,202212,EASTERN EUROPE-EU,LATVIA,BRISTOL,RIGA,2810,2810,0,1399,1399,0,100.857756
15/02/2023 17:21,202212,EASTERN EUROPE-EU,LATVIA,DONCASTER SHEFFIELD,RIGA,0,0,0,984,984,0,-100
15/02/2023 17:21,202212,EASTERN EUROPE-EU,LATVIA,EAST MIDLANDS INTERNATIONAL,RIGA,3400,3400,0,1965,1965,0,73.02799
15/02/2023 17:21,202212,EASTERN EUROPE-EU,LATVIA,EDINBURGH,RIGA,6074,6074,0,2682,2682,0,126.472782
15/02/2023 17:21,202212,EASTERN EUROPE-EU,LATVIA,LEEDS BRADFORD,RIGA,2467,2467,0,1538,1538,0,60.403121
15/02/2023 17:21,202212,EASTERN EUROPE-EU,LATVIA,LIVERPOOL (JOHN LENNON),RIGA,0,0,0,126,126,0,-100
15/02/2023 17:21,202212,EASTERN EUROPE-EU,LATVIA,MANCHESTER,RIGA,4729,4729,0,3044,3044,0,55.354796
15/02/2023 17:21,202212,EASTERN EUROPE-EU,LATVIA,NEWCASTLE,RIGA,2337,2337,0,0,0,0,0
15/02/2023 17:21,202212,EASTERN EUROPE-EU,LITHUANIA,GATWICK,VILNIUS,0,0,0,111,0,111,-100
15/02/2023 17:21,202212,EASTERN EUROPE-EU,LITHUANIA,HEATHROW,VILNIUS,0,0,0,47,47,0,-100
15/02/2023 17:21,202212,EASTERN EUROPE-EU,LITHUANIA,LONDON CITY,VILNIUS,3236,3236,0,1981,1981,0,63.351843
15/02/2023 17:21,202212,EASTERN EUROPE-EU,LITHUANIA,LUTON,KAUNAS,15742,15742,0,11325,11325,0,39.002208
15/02/2023 17:21,202212,EASTERN EUROPE-EU,LITHUANIA,LUTON,PALANGA,3741,3741,0,2320,2320,0,61.25
15/02/2023 17:21,202212,EASTERN EUROPE-EU,LITHUANIA,LUTON,VILNIUS,16793,16793,0,11650,11650,0,44.145923
15/02/2023 17:21,202212,EASTERN EUROPE-EU,LITHUANIA,STANSTED,KAUNAS,7006,7006,0,4619,4619,0,51.677852
15/02/2023 17:21,202212,EASTERN EUROPE-EU,LITHUANIA,STANSTED,PALANGA,4212,4212,0,1985,1985,0,112.191436
15/02/2023 17:21,202212,EASTERN EUROPE-EU,LITHUANIA,STANSTED,VILNIUS,13734,13734,0,6267,6202,65,119.147918
15/02/2023 17:21,202212,EASTERN EUROPE-EU,LITHUANIA,BELFAST INTERNATIONAL,VILNIUS,0,0,0,433,433,0,-100
15/02/2023 17:21,202212,EASTERN EUROPE-EU,LITHUANIA,BIRMINGHAM,VILNIUS,2981,2981,0,2324,2324,0,28.270224
15/02/2023 17:21,202212,EASTERN EUROPE-EU,LITHUANIA,BRISTOL,KAUNAS,3055,3055,0,1907,1907,0,60.199266
15/02/2023 17:21,202212,EASTERN EUROPE-EU,LITHUANIA,DONCASTER SHEFFIELD,VILNIUS,0,0,0,1173,1173,0,-100
15/02/2023 17:21,202212,EASTERN EUROPE-EU,LITHUANIA,DUNDEE,KAUNAS,1,0,1,0,0,0,0
15/02/2023 17:21,202212,EASTERN EUROPE-EU,LITHUANIA,EDINBURGH,KAUNAS,3663,3663,0,1768,1768,0,107.183258
15/02/2023 17:21,202212,EASTERN EUROPE-EU,LITHUANIA,LEEDS BRADFORD,VILNIUS,2286,2286,0,1854,1854,0,23.300971
15/02/2023 17:21,202212,EASTERN EUROPE-EU,LITHUANIA,LIVERPOOL (JOHN LENNON),KAUNAS,2643,2643,0,922,922,0,186.659436
15/02/2023 17:21,202212,EASTERN EUROPE-EU,LITHUANIA,LIVERPOOL (JOHN LENNON),VILNIUS,0,0,0,2236,2236,0,-100
15/02/2023 17:21,202212,EASTERN EUROPE-EU,LITHUANIA,MANCHESTER,KAUNAS,0,0,0,882,882,0,-100
15/02/2023 17:21,202212,EASTERN EUROPE-EU,POLAND,GATWICK,KRAKOW,14674,14674,0,5054,5054,0,190.344282
15/02/2023 17:21,202212,EASTERN EUROPE-EU,POLAND,GATWICK,WARSAW (CHOPIN),0,0,0,59,0,59,-100
15/02/2023 17:21,202212,EASTERN EUROPE-EU,POLAND,HEATHROW,KRAKOW,5459,5459,0,1834,1834,0,197.655398
15/02/2023 17:21,202212,EASTERN EUROPE-EU,POLAND,HEATHROW,WARSAW (CHOPIN),43059,43059,0,16527,16527,0,160.537303
15/02/2023 17:21,202212,EASTERN EUROPE-EU,POLAND,LUTON,BYDGOSZCZ,3697,3697,0,1725,1725,0,114.318841
15/02/2023 17:21,202212,EASTERN EUROPE-EU,POLAND,LUTON,GDANSK,16024,16024,0,10915,10915,0,46.807146
15/02/2023 17:21,202212,EASTERN EUROPE-EU,POLAND,LUTON,KATOWICE,18174,18174,0,9600,9600,0,89.3125
15/02/2023 17:21,202212,EASTERN EUROPE-EU,POLAND,LUTON,KRAKOW,27651,27651,0,18792,18792,0,47.142401
15/02/2023 17:21,202212,EASTERN EUROPE-EU,POLAND,LUTON,LODZ LUBLINEK,1690,1690,0,0,0,0,0
15/02/2023 17:21,202212,EASTERN EUROPE-EU,POLAND,LUTON,LUBLIN (PORT LOTNICZY),15816,15816,0,5732,5732,0,175.924634
15/02/2023 17:21,202212,EASTERN EUROPE-EU,POLAND,LUTON,POZNAN,9853,9853,0,6031,6031,0,63.372575
15/02/2023 17:21,202212,EASTERN EUROPE-EU,POLAND,LUTON,RZESZOW,6422,6422,0,4004,4004,0,60.38961
15/02/2023 17:21,202212,EASTERN EUROPE-EU,POLAND,LUTON,SZYMANY (MAZURY),2964,2964,0,747,747,0,296.787149
15/02/2023 17:21,202212,EASTERN EUROPE-EU,POLAND,LUTON,WARSAW (CHOPIN),28672,28672,0,16411,16411,0,74.712083
15/02/2023 17:21,202212,EASTERN EUROPE-EU,POLAND,LUTON,WROCLAW,14085,14085,0,6075,6075,0,131.851852
15/02/2023 17:21,202212,EASTERN EUROPE-EU,POLAND,STANSTED,BYDGOSZCZ,5617,5617,0,3188,3188,0,76.19197
15/02/2023 17:21,202212,EASTERN EUROPE-EU,POLAND,STANSTED,GDANSK,19609,19609,0,8677,8677,0,125.988245
15/02/2023 17:21,202212,EASTERN EUROPE-EU,POLAND,STANSTED,KATOWICE,17224,17224,0,6683,6683,0,157.728565
15/02/2023 17:21,202212,EASTERN EUROPE-EU,POLAND,STANSTED,KRAKOW,27420,27420,0,13409,13409,0,104.489522
15/02/2023 17:21,202212,EASTERN EUROPE-EU,POLAND,STANSTED,LODZ LUBLINEK,7449,7449,0,4231,4231,0,76.05767
15/02/2023 17:21,202212,EASTERN EUROPE-EU,POLAND,STANSTED,POZNAN,11004,11004,0,6408,6408,0,71.722846
15/02/2023 17:21,202212,EASTERN EUROPE-EU,POLAND,STANSTED,RZESZOW,9883,9883,0,3703,3703,0,166.891709
15/02/2023 17:21,202212,EASTERN EUROPE-EU,POLAND,STANSTED,SZCZECIN (GOLENOW),6576,6576,0,4239,4239,0,55.130927
15/02/2023 17:21,202212,EASTERN EUROPE-EU,POLAND,STANSTED,SZYMANY (MAZURY),2035,2035,0,1359,1359,0,49.742458
15/02/2023 17:21,202212,EASTERN EUROPE-EU,POLAND,STANSTED,WARSAW (MODLIN MASOVIA),31441,31441,0,15985,15985,0,96.690647
15/02/2023 17:21,202212,EASTERN EUROPE-EU,POLAND,STANSTED,WROCLAW,16188,16188,0,8913,8913,0,81.622349
15/02/2023 17:21,202212,EASTERN EUROPE-EU,POLAND,ABERDEEN,GDANSK,3298,3298,0,1136,1136,0,190.316901
15/02/2023 17:21,202212,EASTERN EUROPE-EU,POLAND,BIGGIN HILL,KATOWICE,0,0,0,20,0,20,-100
15/02/2023 17:21,202212,EASTERN EUROPE-EU,POLAND,BIRMINGHAM,BYDGOSZCZ,4407,4407,0,2299,2299,0,91.69204
15/02/2023 17:21,202212,EASTERN EUROPE-EU,POLAND,BIRMINGHAM,GDANSK,3610,3610,0,2209,2209,0,63.422363
15/02/2023 17:21,202212,EASTERN EUROPE-EU,POLAND,BIRMINGHAM,KATOWICE,0,0,0,1275,1275,0,-100
15/02/2023 17:21,202212,EASTERN EUROPE-EU,POLAND,BIRMINGHAM,KRAKOW,8533,8533,0,6005,6005,0,42.098251
15/02/2023 17:21,202212,EASTERN EUROPE-EU,POLAND,BIRMINGHAM,POZNAN,2378,2378,0,1404,1404,0,69.373219
15/02/2023 17:21,202212,EASTERN EUROPE-EU,POLAND,BIRMINGHAM,WARSAW (CHOPIN),4158,4158,0,1710,1710,0,143.157895
15/02/2023 17:21,202212,EASTERN EUROPE-EU,POLAND,BIRMINGHAM,WARSAW (MODLIN MASOVIA),3646,3646,0,2494,2494,0,46.190858
15/02/2023 17:21,202212,EASTERN EUROPE-EU,POLAND,BIRMINGHAM,WROCLAW,3124,3124,0,915,915,0,241.420765
15/02/2023 17:21,202212,EASTERN EUROPE-EU,POLAND,BOURNEMOUTH,KRAKOW,3758,3758,0,1859,1859,0,102.151694
15/02/2023 17:21,202212,EASTERN EUROPE-EU,POLAND,BOURNEMOUTH,WROCLAW,3076,3076,0,1375,1375,0,123.709091
15/02/2023 17:21,202212,EASTERN EUROPE-EU,POLAND,BRISTOL,BYDGOSZCZ,2560,2560,0,0,0,0,0
15/02/2023 17:21,202212,EASTERN EUROPE-EU,POLAND,BRISTOL,GDANSK,3421,3421,0,2420,2420,0,41.363636
15/02/2023 17:21,202212,EASTERN EUROPE-EU,POLAND,BRISTOL,KATOWICE,2795,2795,0,1500,1500,0,86.333333
15/02/2023 17:21,202212,EASTERN EUROPE-EU,POLAND,BRISTOL,KRAKOW,11344,11344,0,6286,6286,0,80.464524
15/02/2023 17:21,202212,EASTERN EUROPE-EU,POLAND,BRISTOL,POZNAN,3502,3502,0,2068,2068,0,69.34236
15/02/2023 17:21,202212,EASTERN EUROPE-EU,POLAND,BRISTOL,RZESZOW,2720,2720,0,1600,1600,0,70
15/02/2023 17:21,202212,EASTERN EUROPE-EU,POLAND,BRISTOL,WARSAW (MODLIN MASOVIA),3918,3918,0,3241,3241,0,20.888615
15/02/2023 17:21,202212,EASTERN EUROPE-EU,POLAND,BRISTOL,WROCLAW,3121,3121,0,1793,1793,0,74.065811
15/02/2023 17:21,202212,EASTERN EUROPE-EU,POLAND,CARDIFF WALES,KATOWICE,0,0,0,76,76,0,-100
15/02/2023 17:21,202212,EASTERN EUROPE-EU,POLAND,DONCASTER SHEFFIELD,GDANSK,0,0,0,2790,2790,0,-100
15/02/2023 17:21,202212,EASTERN EUROPE-EU,POLAND,DONCASTER SHEFFIELD,KATOWICE,0,0,0,2056,2056,0,-100
15/02/2023 17:21,202212,EASTERN EUROPE-EU,POLAND,DONCASTER SHEFFIELD,KRAKOW,0,0,0,1726,1726,0,-100
15/02/2023 17:21,202212,EASTERN EUROPE-EU,POLAND,DONCASTER SHEFFIELD,LUBLIN (PORT LOTNICZY),0,0,0,1094,1094,0,-100
15/02/2023 17:21,202212,EASTERN EUROPE-EU,POLAND,DONCASTER SHEFFIELD,POZNAN,0,0,0,2046,2046,0,-100
15/02/2023 17:21,202212,EASTERN EUROPE-EU,POLAND,DONCASTER SHEFFIELD,WARSAW (CHOPIN),0,0,0,2782,2782,0,-100
15/02/2023 17:21,202212,EASTERN EUROPE-EU,POLAND,DONCASTER SHEFFIELD,WROCLAW,0,0,0,929,929,0,-100
15/02/2023 17:21,202212,EASTERN EUROPE-EU,POLAND,EAST MIDLANDS INTERNATIONAL,KRAKOW,4005,4005,0,2264,2264,0,76.899293
15/02/2023 17:21,202212,EASTERN EUROPE-EU,POLAND,EAST MIDLANDS INTERNATIONAL,LODZ LUBLINEK,0,0,0,1875,1875,0,-100
15/02/2023 17:21,202212,EASTERN EUROPE-EU,POLAND,EAST MIDLANDS INTERNATIONAL,RZESZOW,2976,2976,0,1588,1588,0,87.405542
15/02/2023 17:21,202212,EASTERN EUROPE-EU,POLAND,EAST MIDLANDS INTERNATIONAL,WARSAW (MODLIN MASOVIA),0,0,0,1627,1627,0,-100
15/02/2023 17:21,202212,EASTERN EUROPE-EU,POLAND,EAST MIDLANDS INTERNATIONAL,WROCLAW,4005,4005,0,2327,2327,0,72.110013
15/02/2023 17:21,202212,EASTERN EUROPE-EU,POLAND,EDINBURGH,GDANSK,8226,8226,0,4136,4136,0,98.887814
15/02/2023 17:21,202212,EASTERN EUROPE-EU,POLAND,EDINBURGH,KATOWICE,4097,4097,0,2188,2188,0,87.248629
15/02/2023 17:21,202212,EASTERN EUROPE-EU,POLAND,EDINBURGH,KRAKOW,12473,12473,0,5539,5539,0,125.185051
15/02/2023 17:21,202212,EASTERN EUROPE-EU,POLAND,EDINBURGH,POZNAN,2674,2674,0,2109,2109,0,26.789948
15/02/2023 17:21,202212,EASTERN EUROPE-EU,POLAND,EDINBURGH,WARSAW (CHOPIN),3049,3049,0,1016,1016,0,200.098425
15/02/2023 17:21,202212,EASTERN EUROPE-EU,POLAND,EDINBURGH,WARSAW (MODLIN MASOVIA),3297,3297,0,3501,3501,0,-5.826907
15/02/2023 17:21,202212,EASTERN EUROPE-EU,POLAND,EDINBURGH,WROCLAW,3271,3271,0,1487,1487,0,119.9731
15/02/2023 17:21,202212,EASTERN EUROPE-EU,POLAND,EXETER,KRAKOW,0,0,0,132,132,0,-100
15/02/2023 17:21,202212,EASTERN EUROPE-EU,POLAND,GLASGOW,KRAKOW,2547,2547,0,2917,2917,0,-12.684265
15/02/2023 17:21,202212,EASTERN EUROPE-EU,POLAND,GLASGOW,WROCLAW,0,0,0,1513,1513,0,-100
15/02/2023 17:21,202212,EASTERN EUROPE-EU,POLAND,LEEDS BRADFORD,GDANSK,7246,7246,0,1662,1662,0,335.980746
15/02/2023 17:21,202212,EASTERN EUROPE-EU,POLAND,LEEDS BRADFORD,KATOWICE,3798,3798,0,0,0,0,0
15/02/2023 17:21,202212,EASTERN EUROPE-EU,POLAND,LEEDS BRADFORD,KRAKOW,11816,11816,0,4952,4952,0,138.610662
15/02/2023 17:21,202212,EASTERN EUROPE-EU,POLAND,LEEDS BRADFORD,POZNAN,2436,2436,0,645,645,0,277.674419
15/02/2023 17:21,202212,EASTERN EUROPE-EU,POLAND,LEEDS BRADFORD,WARSAW (CHOPIN),4165,4165,0,0,0,0,0
15/02/2023 17:21,202212,EASTERN EUROPE-EU,POLAND,LEEDS BRADFORD,WARSAW (MODLIN MASOVIA),3069,3069,0,1756,1756,0,74.77221
15/02/2023 17:21,202212,EASTERN EUROPE-EU,POLAND,LEEDS BRADFORD,WROCLAW,5286,5286,0,1457,1457,0,262.800275
15/02/2023 17:21,202212,EASTERN EUROPE-EU,POLAND,LIVERPOOL (JOHN LENNON),GDANSK,2851,2851,0,1517,1517,0,87.936717
15/02/2023 17:21,202212,EASTERN EUROPE-EU,POLAND,LIVERPOOL (JOHN LENNON),KATOWICE,2383,2383,0,709,709,0,236.107193
15/02/2023 17:21,202212,EASTERN EUROPE-EU,POLAND,LIVERPOOL (JOHN LENNON),KRAKOW,5167,5167,0,4266,4266,0,21.120488
15/02/2023 17:21,202212,EASTERN EUROPE-EU,POLAND,LIVERPOOL (JOHN LENNON),POZNAN,2294,2294,0,1908,1908,0,20.230608
15/02/2023 17:21,202212,EASTERN EUROPE-EU,POLAND,LIVERPOOL (JOHN LENNON),SZCZECIN (GOLENOW),2321,2321,0,1598,1598,0,45.244055
15/02/2023 17:21,202212,EASTERN EUROPE-EU,POLAND,LIVERPOOL (JOHN LENNON),WARSAW (CHOPIN),3970,3970,0,1991,1991,0,99.397288
15/02/2023 17:21,202212,EASTERN EUROPE-EU,POLAND,LIVERPOOL (JOHN LENNON),WARSAW (MODLIN MASOVIA),2618,2618,0,2369,2369,0,10.510764
15/02/2023 17:21,202212,EASTERN EUROPE-EU,POLAND,LIVERPOOL (JOHN LENNON),WROCLAW,3044,3044,0,1368,1368,0,122.51462
15/02/2023 17:21,202212,EASTERN EUROPE-EU,POLAND,MANCHESTER,GDANSK,4559,4559,0,2729,2729,0,67.05753
15/02/2023 17:21,202212,EASTERN EUROPE-EU,POLAND,MANCHESTER,KATOWICE,2175,2175,0,1846,1846,0,17.822319
15/02/2023 17:21,202212,EASTERN EUROPE-EU,POLAND,MANCHESTER,KRAKOW,13287,13287,0,9051,9051,0,46.801458
15/02/2023 17:21,202212,EASTERN EUROPE-EU,POLAND,MANCHESTER,POZNAN,2738,2738,0,1401,1401,0,95.431834
15/02/2023 17:21,202212,EASTERN EUROPE-EU,POLAND,MANCHESTER,RZESZOW,3139,3139,0,1504,1504,0,108.710106
15/02/2023 17:21,202212,EASTERN EUROPE-EU,POLAND,MANCHESTER,WARSAW (MODLIN MASOVIA),4242,4242,0,1526,1526,0,177.981651
15/02/2023 17:21,202212,EASTERN EUROPE-EU,POLAND,MANCHESTER,WROCLAW,2816,2816,0,1667,1667,0,68.926215
15/02/2023 17:21,202212,EASTERN EUROPE-EU,POLAND,NEWCASTLE,GDANSK,2615,2615,0,1204,1204,0,117.192691
15/02/2023 17:21,202212,EASTERN EUROPE-EU,POLAND,NEWCASTLE,KRAKOW,6251,6251,0,3361,3361,0,85.986314
15/02/2023 17:21,202212,EASTERN EUROPE-EU,POLAND,NEWCASTLE,WROCLAW,2141,2141,0,1415,1415,0,51.30742
15/02/2023 17:21,202212,EASTERN EUROPE-EU,ROMANIA,GATWICK,BUCHAREST (OTOPENI),9660,9660,0,2262,2262,0,327.055703
15/02/2023 17:21,202212,EASTERN EUROPE-EU,ROMANIA,HEATHROW,BUCHAREST (OTOPENI),18115,18115,0,12726,12726,0,42.346377
15/02/2023 17:21,202212,EASTERN EUROPE-EU,ROMANIA,HEATHROW,IASI,0,0,0,177,177,0,-100
15/02/2023 17:21,202212,EASTERN EUROPE-EU,ROMANIA,LUTON,BACAU,12104,12104,0,12407,12407,0,-2.44217
15/02/2023 17:21,202212,EASTERN EUROPE-EU,ROMANIA,LUTON,BUCHAREST (OTOPENI),42617,42617,0,26293,26293,0,62.084966
15/02/2023 17:21,202212,EASTERN EUROPE-EU,ROMANIA,LUTON,CLUJ NAPOCA,21150,21150,0,12986,12986,0,62.867704
15/02/2023 17:21,202212,EASTERN EUROPE-EU,ROMANIA,LUTON,CONSTANTA,3986,3986,0,2703,2703,0,47.465779
15/02/2023 17:21,202212,EASTERN EUROPE-EU,ROMANIA,LUTON,CRAIOVA,11517,11517,0,6835,6835,0,68.500366
15/02/2023 17:21,202212,EASTERN EUROPE-EU,ROMANIA,LUTON,IASI,19590,19590,0,9960,9960,0,96.686747
15/02/2023 17:21,202212,EASTERN EUROPE-EU,ROMANIA,LUTON,SATU MARE,3133,3133,0,1699,1699,0,84.40259
15/02/2023 17:21,202212,EASTERN EUROPE-EU,ROMANIA,LUTON,SIBIU,8351,8351,0,3735,3735,0,123.587684
15/02/2023 17:21,202212,EASTERN EUROPE-EU,ROMANIA,LUTON,SUCEAVA,14753,14753,0,9407,9407,0,56.83002
15/02/2023 17:21,202212,EASTERN EUROPE-EU,ROMANIA,LUTON,TIMISOARA,10686,10686,0,5433,5433,0,96.686913
15/02/2023 17:21,202212,EASTERN EUROPE-EU,ROMANIA,LUTON,TIRGU MURES,3924,3924,0,1848,1848,0,112.337662
15/02/2023 17:21,202212,EASTERN EUROPE-EU,ROMANIA,STANSTED,BUCHAREST (OTOPENI),32625,32625,0,14946,14946,0,118.285829
15/02/2023 17:21,202212,EASTERN EUROPE-EU,ROMANIA,STANSTED,CLUJ NAPOCA,3381,3381,0,2499,2499,0,35.294118
15/02/2023 17:21,202212,EASTERN EUROPE-EU,ROMANIA,STANSTED,ORADEA,2462,2462,0,1783,1783,0,38.081884
15/02/2023 17:21,202212,EASTERN EUROPE-EU,ROMANIA,BIRMINGHAM,BUCHAREST (OTOPENI),13428,13428,0,9589,9589,0,40.035457
15/02/2023 17:21,202212,EASTERN EUROPE-EU,ROMANIA,BIRMINGHAM,CLUJ NAPOCA,3030,3030,0,1059,1059,0,186.11898
15/02/2023 17:21,202212,EASTERN EUROPE-EU,ROMANIA,BIRMINGHAM,CRAIOVA,3858,3858,0,1836,1836,0,110.130719
15/02/2023 17:21,202212,EASTERN EUROPE-EU,ROMANIA,BIRMINGHAM,IASI,0,0,0,722,722,0,-100
15/02/2023 17:21,202212,EASTERN EUROPE-EU,ROMANIA,BRISTOL,BUCHAREST (OTOPENI),3726,3726,0,2379,2379,0,56.620429
15/02/2023 17:21,202212,EASTERN EUROPE-EU,ROMANIA,CARDIFF WALES,BUCHAREST (OTOPENI),1254,1254,0,0,0,0,0
15/02/2023 17:21,202212,EASTERN EUROPE-EU,ROMANIA,DONCASTER SHEFFIELD,BUCHAREST (OTOPENI),0,0,0,4648,4648,0,-100
15/02/2023 17:21,202212,EASTERN EUROPE-EU,ROMANIA,DONCASTER SHEFFIELD,CLUJ NAPOCA,0,0,0,2094,2094,0,-100
15/02/2023 17:21,202212,EASTERN EUROPE-EU,ROMANIA,DONCASTER SHEFFIELD,CRAIOVA,0,0,0,291,0,291,-100
15/02/2023 17:21,202212,EASTERN EUROPE-EU,ROMANIA,DONCASTER SHEFFIELD,SUCEAVA,0,0,0,356,356,0,-100
15/02/2023 17:21,202212,EASTERN EUROPE-EU,ROMANIA,EDINBURGH,BUCHAREST (OTOPENI),6052,6052,0,4241,4241,0,42.702193
15/02/2023 17:21,202212,EASTERN EUROPE-EU,ROMANIA,LEEDS BRADFORD,BUCHAREST (OTOPENI),5010,5010,0,0,0,0,0
15/02/2023 17:21,202212,EASTERN EUROPE-EU,ROMANIA,LEEDS BRADFORD,CLUJ NAPOCA,3914,3914,0,0,0,0,0
15/02/2023 17:21,202212,EASTERN EUROPE-EU,ROMANIA,LIVERPOOL (JOHN LENNON),BACAU,2518,2518,0,833,833,0,202.280912
15/02/2023 17:21,202212,EASTERN EUROPE-EU,ROMANIA,LIVERPOOL (JOHN LENNON),BUCHAREST (OTOPENI),4774,4774,0,3477,3477,0,37.302272
15/02/2023 17:21,202212,EASTERN EUROPE-EU,ROMANIA,LIVERPOOL (JOHN LENNON),CLUJ NAPOCA,623,623,0,547,547,0,13.893967
15/02/2023 17:21,202212,EASTERN EUROPE-EU,ROMANIA,LIVERPOOL (JOHN LENNON),IASI,3288,3288,0,1044,1044,0,214.942529
15/02/2023 17:21,202212,EASTERN EUROPE-EU,ROMANIA,LIVERPOOL (JOHN LENNON),SIBIU,0,0,0,943,943,0,-100
15/02/2023 17:21,202212,EASTERN EUROPE-EU,ROMANIA,MANCHESTER,BUCHAREST (OTOPENI),4198,4198,0,2137,2137,0,96.443613
15/02/2023 17:21,202212,EASTERN EUROPE-EU,ROMANIA,MANCHESTER,SUCEAVA,2597,2597,0,1060,1060,0,145
15/02/2023 17:21,202212,EASTERN EUROPE-EU,SLOVAK REPUBLIC,LUTON,BRATISLAVA,4867,4867,0,1979,1979,0,145.932289
15/02/2023 17:21,202212,EASTERN EUROPE-EU,SLOVAK REPUBLIC,LUTON,KOSICE,5986,5986,0,3792,3792,0,57.85865
15/02/2023 17:21,202212,EASTERN EUROPE-EU,SLOVAK REPUBLIC,LUTON,TATRY-POPRAD,2776,2776,0,1340,1340,0,107.164179
15/02/2023 17:21,202212,EASTERN EUROPE-EU,SLOVAK REPUBLIC,STANSTED,BRATISLAVA,9923,9923,0,4520,4520,0,119.535398
15/02/2023 17:21,202212,EASTERN EUROPE-EU,SLOVAK REPUBLIC,STANSTED,KOSICE,6166,6166,0,1764,1764,0,249.546485
15/02/2023 17:21,202212,EASTERN EUROPE-EU,SLOVAK REPUBLIC,BIRMINGHAM,BRATISLAVA,0,0,0,1509,1509,0,-100
15/02/2023 17:21,202212,EASTERN EUROPE-EU,SLOVAK REPUBLIC,DONCASTER SHEFFIELD,KOSICE,0,0,0,1716,1716,0,-100
15/02/2023 17:21,202212,EASTERN EUROPE-EU,SLOVAK REPUBLIC,EDINBURGH,BRATISLAVA,2981,2981,0,0,0,0,0
15/02/2023 17:21,202212,EASTERN EUROPE-EU,SLOVAK REPUBLIC,LEEDS BRADFORD,BRATISLAVA,2507,2507,0,766,766,0,227.284595
15/02/2023 17:21,202212,EASTERN EUROPE-EU,SLOVAK REPUBLIC,LIVERPOOL (JOHN LENNON),BRATISLAVA,120,120,0,0,0,0,0
15/02/2023 17:21,202212,EASTERN EUROPE-EU,SLOVAK REPUBLIC,LIVERPOOL (JOHN LENNON),KOSICE,2973,2973,0,1512,1512,0,96.626984
15/02/2023 17:21,202212,EASTERN EUROPE-EU,SLOVAK REPUBLIC,MANCHESTER,BRATISLAVA,3247,3247,0,1511,1511,0,114.890801
15/02/2023 17:21,202212,EASTERN EUROPE -OTHER,ALBANIA,GATWICK,TIRANA,2527,2371,156,2603,2476,127,-2.919708
15/02/2023 17:21,202212,EASTERN EUROPE -OTHER,ALBANIA,HEATHROW,TIRANA,4476,4476,0,6638,6638,0,-32.570051
15/02/2023 17:21,202212,EASTERN EUROPE -OTHER,ALBANIA,LUTON,TIRANA,27025,27025,0,16033,16033,0,68.558598
15/02/2023 17:21,202212,EASTERN EUROPE -OTHER,ALBANIA,STANSTED,TIRANA,1194,1194,0,0,0,0,0
15/02/2023 17:21,202212,EASTERN EUROPE -OTHER,ALBANIA,BIRMINGHAM,TIRANA,115,0,115,0,0,0,0
15/02/2023 17:21,202212,EASTERN EUROPE -OTHER,ALBANIA,LIVERPOOL (JOHN LENNON),TIRANA,0,0,0,1372,1372,0,-100
15/02/2023 17:21,202212,EASTERN EUROPE -OTHER,AZERBAIJAN,HEATHROW,BAKU (HEYDER ALIYEV INT'L),3880,3880,0,1595,1595,0,143.260188
15/02/2023 17:21,202212,EASTERN EUROPE -OTHER,KAZAKHSTAN,HEATHROW,AKTAU,1748,1748,0,0,0,0,0
15/02/2023 17:21,202212,EASTERN EUROPE -OTHER,KAZAKHSTAN,HEATHROW,ALMATY,1601,1601,0,0,0,0,0
15/02/2023 17:21,202212,EASTERN EUROPE -OTHER,KAZAKHSTAN,HEATHROW,NURSULTAN NAZERBAYEV INTERNATIONAL,0,0,0,1095,1095,0,-100
15/02/2023 17:21,202212,EASTERN EUROPE -OTHER,REPUBLIC OF MOLDOVA,LUTON,CHISINAU (KISHINEV),16732,16732,0,13247,13247,0,26.307843
15/02/2023 17:21,202212,EASTERN EUROPE -OTHER,REPUBLIC OF MOLDOVA,STANSTED,CHISINAU (KISHINEV),5169,5169,0,3721,3721,0,38.91427
15/02/2023 17:21,202212,EASTERN EUROPE -OTHER,REPUBLIC OF MOLDOVA,LIVERPOOL (JOHN LENNON),CHISINAU (KISHINEV),0,0,0,1223,1223,0,-100
15/02/2023 17:21,202212,EASTERN EUROPE -OTHER,RUSSIA,GATWICK,ST PETERSBURG,0,0,0,237,0,237,-100
15/02/2023 17:21,202212,EASTERN EUROPE -OTHER,RUSSIA,HEATHROW,MOSCOW (DOMODEDOVO),0,0,0,4952,4952,0,-100
15/02/2023 17:21,202212,EASTERN EUROPE -OTHER,RUSSIA,HEATHROW,MOSCOW (SHEREMETYEVO),0,0,0,10091,10091,0,-100
15/02/2023 17:21,202212,EASTERN EUROPE -OTHER,RUSSIA,BIGGIN HILL,MOSCOW (VNUKOVO),0,0,0,2,0,2,-100
15/02/2023 17:21,202212,EASTERN EUROPE -OTHER,RUSSIA,BIGGIN HILL,ST PETERSBURG,0,0,0,4,0,4,-100
15/02/2023 17:21,202212,EASTERN EUROPE -OTHER,UKRAINE,GATWICK,KIEV (BORISPOL),0,0,0,4756,4756,0,-100
15/02/2023 17:21,202212,EASTERN EUROPE -OTHER,UKRAINE,LUTON,KIEV (ZHULYANY),0,0,0,3645,3645,0,-100
15/02/2023 17:21,202212,EASTERN EUROPE -OTHER,UKRAINE,LUTON,LVOV,0,0,0,3785,3785,0,-100
15/02/2023 17:21,202212,EASTERN EUROPE -OTHER,UKRAINE,STANSTED,KIEV (BORISPOL),0,0,0,5649,5649,0,-100
15/02/2023 17:21,202212,EASTERN EUROPE -OTHER,UKRAINE,STANSTED,LVOV,0,0,0,2844,2844,0,-100
15/02/2023 17:21,202212,EASTERN EUROPE -OTHER,UKRAINE,MANCHESTER,KIEV (BORISPOL),0,0,0,2022,2022,0,-100
15/02/2023 17:21,202212,EASTERN EUROPE -OTHER,UKRAINE,MANCHESTER,LVOV,0,0,0,1144,1144,0,-100
15/02/2023 17:21,202212,EASTERN EUROPE -OTHER,UZBEKISTAN,HEATHROW,TASHKENT,2425,2425,0,861,861,0,181.649245
15/02/2023 17:21,202212,NEAR EAST,ISRAEL,GATWICK,TEL AVIV,18125,18125,0,1266,1266,0,1331.674566
15/02/2023 17:21,202212,NEAR EAST,ISRAEL,HEATHROW,TEL AVIV,59307,59307,0,15430,15430,0,284.361633
15/02/2023 17:21,202212,NEAR EAST,ISRAEL,LUTON,RAMON,134,0,134,0,0,0,0
15/02/2023 17:21,202212,NEAR EAST,ISRAEL,LUTON,TEL AVIV,36548,36548,0,6863,6863,0,432.536791
15/02/2023 17:21,202212,NEAR EAST,ISRAEL,MANCHESTER,TEL AVIV,4166,4166,0,1293,1293,0,222.196442
15/02/2023 17:21,202212,NEAR EAST,JORDAN,GATWICK,AQABA,2525,2525,0,968,968,0,160.847107
15/02/2023 17:21,202212,NEAR EAST,JORDAN,HEATHROW,AMMAN,20175,20175,0,15014,15014,0,34.374584
15/02/2023 17:21,202212,NEAR EAST,JORDAN,LUTON,AMMAN,2995,2995,0,0,0,0,0
15/02/2023 17:21,202212,NEAR EAST,JORDAN,MANCHESTER,AQABA,0,0,0,492,492,0,-100
15/02/2023 17:21,202212,NEAR EAST,LEBANON,HEATHROW,BEIRUT,16166,16166,0,10769,10769,0,50.116074
15/02/2023 17:21,202212,NORTH AFRICA,ALGERIA,HEATHROW,ALGIERS,10012,10012,0,6239,6239,0,60.474435
15/02/2023 17:21,202212,NORTH AFRICA,EGYPT,GATWICK,HURGHADA,16008,16008,0,11950,11950,0,33.958159
15/02/2023 17:21,202212,NORTH AFRICA,EGYPT,GATWICK,SHARM EL SHEIKH (OPHIRA),13965,13965,0,6554,6554,0,113.075984
15/02/2023 17:21,202212,NORTH AFRICA,EGYPT,HEATHROW,CAIRO,47990,47990,0,30708,30708,0,56.278494
15/02/2023 17:21,202212,NORTH AFRICA,EGYPT,HEATHROW,LUXOR,751,751,0,312,312,0,140.705128
15/02/2023 17:21,202212,NORTH AFRICA,EGYPT,LUTON,HURGHADA,4938,4938,0,1601,1601,0,208.43223
15/02/2023 17:21,202212,NORTH AFRICA,EGYPT,LUTON,SHARM EL SHEIKH (OPHIRA),8744,8744,0,1360,1360,0,542.941176
15/02/2023 17:21,202212,NORTH AFRICA,EGYPT,STANSTED,SHARM EL SHEIKH (OPHIRA),973,973,0,378,378,0,157.407407
15/02/2023 17:21,202212,NORTH AFRICA,EGYPT,BIGGIN HILL,CAIRO,8,0,8,0,0,0,0
15/02/2023 17:21,202212,NORTH AFRICA,EGYPT,BIRMINGHAM,HURGHADA,3845,3845,0,3248,3248,0,18.380542
15/02/2023 17:21,202212,NORTH AFRICA,EGYPT,BIRMINGHAM,SHARM EL SHEIKH (OPHIRA),2836,2836,0,1831,1831,0,54.888039
15/02/2023 17:21,202212,NORTH AFRICA,EGYPT,BRISTOL,HURGHADA,5767,5767,0,2492,2492,0,131.420546
15/02/2023 17:21,202212,NORTH AFRICA,EGYPT,BRISTOL,SHARM EL SHEIKH (OPHIRA),2823,2823,0,1229,1229,0,129.698942
15/02/2023 17:21,202212,NORTH AFRICA,EGYPT,DONCASTER SHEFFIELD,HURGHADA,0,0,0,652,652,0,-100
15/02/2023 17:21,202212,NORTH AFRICA,EGYPT,GLASGOW,SHARM EL SHEIKH (OPHIRA),1602,1602,0,0,0,0,0
15/02/2023 17:21,202212,NORTH AFRICA,EGYPT,MANCHESTER,HURGHADA,9732,9732,0,5901,5901,0,64.9212
15/02/2023 17:21,202212,NORTH AFRICA,EGYPT,MANCHESTER,SHARM EL SHEIKH (OPHIRA),8340,8340,0,5094,5094,0,63.722026
15/02/2023 17:21,202212,NORTH AFRICA,EGYPT,NEWCASTLE,HURGHADA,2020,2020,0,1245,1245,0,62.248996
15/02/2023 17:21,202212,NORTH AFRICA,MOROCCO,GATWICK,AGADIR (AL MASSIRA),16250,16250,0,0,0,0,0
15/02/2023 17:21,202212,NORTH AFRICA,MOROCCO,GATWICK,CASABLANCA MOHAMED V,7432,7432,0,0,0,0,0
15/02/2023 17:21,202212,NORTH AFRICA,MOROCCO,GATWICK,MARRAKESH,44308,44308,0,0,0,0,0
15/02/2023 17:21,202212,NORTH AFRICA,MOROCCO,GATWICK,TANGIERS (IBN BATUTA),2952,2952,0,0,0,0,0
15/02/2023 17:21,202212,NORTH AFRICA,MOROCCO,HEATHROW,CASABLANCA MOHAMED V,14140,14140,0,0,0,0,0
15/02/2023 17:21,202212,NORTH AFRICA,MOROCCO,HEATHROW,MARRAKESH,5885,5885,0,0,0,0,0
15/02/2023 17:21,202212,NORTH AFRICA,MOROCCO,LUTON,AGADIR (AL MASSIRA),1725,1725,0,0,0,0,0
15/02/2023 17:21,202212,NORTH AFRICA,MOROCCO,LUTON,MARRAKESH,3704,3704,0,0,0,0,0
15/02/2023 17:21,202212,NORTH AFRICA,MOROCCO,STANSTED,AGADIR (AL MASSIRA),5309,5309,0,0,0,0,0
15/02/2023 17:21,202212,NORTH AFRICA,MOROCCO,STANSTED,ESSAOUIRA,1816,1816,0,0,0,0,0
15/02/2023 17:21,202212,NORTH AFRICA,MOROCCO,STANSTED,FEZ,2598,2598,0,0,0,0,0
15/02/2023 17:21,202212,NORTH AFRICA,MOROCCO,STANSTED,MARRAKESH,13891,13891,0,0,0,0,0
15/02/2023 17:21,202212,NORTH AFRICA,MOROCCO,STANSTED,RABAT,4892,4892,0,0,0,0,0
15/02/2023 17:21,202212,NORTH AFRICA,MOROCCO,STANSTED,TANGIERS (IBN BATUTA),2276,2276,0,0,0,0,0
15/02/2023 17:21,202212,NORTH AFRICA,MOROCCO,BIGGIN HILL,FEZ,8,0,8,0,0,0,0
15/02/2023 17:21,202212,NORTH AFRICA,MOROCCO,EDINBURGH,MARRAKESH,2380,2380,0,0,0,0,0
15/02/2023 17:21,202212,NORTH AFRICA,MOROCCO,GLASGOW,AGADIR (AL MASSIRA),2453,2453,0,0,0,0,0
15/02/2023 17:21,202212,NORTH AFRICA,MOROCCO,MANCHESTER,AGADIR (AL MASSIRA),10511,10511,0,0,0,0,0
15/02/2023 17:21,202212,NORTH AFRICA,MOROCCO,MANCHESTER,MARRAKESH,12942,12942,0,0,0,0,0
15/02/2023 17:21,202212,NORTH AFRICA,TUNISIA,GATWICK,ENFIDHA - HAMMAMET INTL,5690,3974,1716,1113,0,1113,411.230907
15/02/2023 17:21,202212,NORTH AFRICA,TUNISIA,GATWICK,TUNIS,3568,3568,0,796,796,0,348.241206
15/02/2023 17:21,202212,NORTH AFRICA,TUNISIA,HEATHROW,TUNIS,594,594,0,1666,1666,0,-64.345738
15/02/2023 17:21,202212,NORTH AFRICA,TUNISIA,LUTON,TUNIS,169,169,0,0,0,0,0
15/02/2023 17:21,202212,NORTH AFRICA,TUNISIA,STANSTED,TUNIS,1373,1373,0,0,0,0,0
15/02/2023 17:21,202212,NORTH AFRICA,TUNISIA,BIRMINGHAM,ENFIDHA - HAMMAMET INTL,1613,0,1613,619,0,619,160.581583
15/02/2023 17:21,202212,NORTH AFRICA,TUNISIA,MANCHESTER,ENFIDHA - HAMMAMET INTL,4121,2386,1735,1157,0,1157,256.179775
15/02/2023 17:21,202212,EAST AFRICA,ETHIOPIA,HEATHROW,ADDIS ABABA,21001,21001,0,14480,14480,0,45.03453
15/02/2023 17:21,202212,EAST AFRICA,ETHIOPIA,MANCHESTER,ADDIS ABABA,7371,7371,0,2904,2904,0,153.822314
15/02/2023 17:21,202212,EAST AFRICA,KENYA,HEATHROW,NAIROBI,32688,32688,0,20028,20028,0,63.211504
15/02/2023 17:21,202212,EAST AFRICA,RWANDA,HEATHROW,KIGALI,5664,5664,0,1418,1418,0,299.435825
15/02/2023 17:21,202212,WEST AFRICA,GAMBIA,GATWICK,BANJUL,6027,0,6027,3911,0,3911,54.10381
15/02/2023 17:21,202212,WEST AFRICA,GAMBIA,MANCHESTER,BANJUL,2967,0,2967,1848,0,1848,60.551948
15/02/2023 17:21,202212,WEST AFRICA,GHANA,HEATHROW,ACCRA,18262,18262,0,17913,17913,0,1.948306
15/02/2023 17:21,202212,WEST AFRICA,NIGERIA,HEATHROW,ABUJA,13016,13016,0,11223,11223,0,15.97612
15/02/2023 17:21,202212,WEST AFRICA,NIGERIA,HEATHROW,LAGOS,29541,29541,0,26044,26044,0,13.427277
15/02/2023 17:21,202212,WEST AFRICA,SENEGAL,GATWICK,DAKAR (BLAISE DIAGNE),1458,0,1458,0,0,0,0
15/02/2023 17:21,202212,SOUTHERN AFRICA,REPUBLIC OF SOUTH AFRICA,GATWICK,CAPE TOWN,3547,3547,0,0,0,0,0
15/02/2023 17:21,202212,SOUTHERN AFRICA,REPUBLIC OF SOUTH AFRICA,HEATHROW,CAPE TOWN,46793,46793,0,10466,10466,0,347.095356
15/02/2023 17:21,202212,SOUTHERN AFRICA,REPUBLIC OF SOUTH AFRICA,HEATHROW,JOHANNESBURG,51711,51711,0,15733,15733,0,228.678574
15/02/2023 17:21,202212,MIDDLE EAST,BAHRAIN,HEATHROW,BAHRAIN,41132,41132,0,33839,33839,0,21.552055
15/02/2023 17:21,202212,MIDDLE EAST,BAHRAIN,MANCHESTER,BAHRAIN,4307,4307,0,0,0,0,0
15/02/2023 17:21,202212,MIDDLE EAST,IRAN,HEATHROW,TEHRAN IMAM KHOMEINI,3609,3609,0,4454,4454,0,-18.971711
15/02/2023 17:21,202212,MIDDLE EAST,IRAQ,GATWICK,BAGHDAD (GECA),0,0,0,307,307,0,-100
15/02/2023 17:21,202212,MIDDLE EAST,IRAQ,GATWICK,SULAYMANIYAH INT,0,0,0,21,21,0,-100
15/02/2023 17:21,202212,MIDDLE EAST,KUWAIT,HEATHROW,KUWAIT,34800,34800,0,24426,24426,0,42.471137
15/02/2023 17:21,202212,MIDDLE EAST,KUWAIT,MANCHESTER,KUWAIT,3859,3859,0,0,0,0,0
15/02/2023 17:21,202212,MIDDLE EAST,OMAN,HEATHROW,MUSCAT,14194,14194,0,6318,6318,0,124.659702
15/02/2023 17:21,202212,MIDDLE EAST,QATAR,GATWICK,DOHA HAMAD,33511,33511,0,6282,6282,0,433.444763
15/02/2023 17:21,202212,MIDDLE EAST,QATAR,HEATHROW,DOHA HAMAD,152601,152467,134,85240,85240,0,79.025106
15/02/2023 17:21,202212,MIDDLE EAST,QATAR,BIRMINGHAM,DOHA HAMAD,55,55,0,0,0,0,0
15/02/2023 17:21,202212,MIDDLE EAST,QATAR,CARDIFF WALES,DOHA HAMAD,76,0,76,0,0,0,0
15/02/2023 17:21,202212,MIDDLE EAST,QATAR,EDINBURGH,DOHA HAMAD,14951,14951,0,5484,5484,0,172.629468
15/02/2023 17:21,202212,MIDDLE EAST,QATAR,MANCHESTER,DOHA HAMAD,52389,52389,0,30851,30851,0,69.812972
15/02/2023 17:21,202212,MIDDLE EAST,SAUDI ARABIA,GATWICK,RIYADH,99,0,99,0,0,0,0
15/02/2023 17:21,202212,MIDDLE EAST,SAUDI ARABIA,HEATHROW,JEDDAH,18551,18551,0,12321,12139,182,50.564078
15/02/2023 17:21,202212,MIDDLE EAST,SAUDI ARABIA,HEATHROW,NEOM BAY,246,246,0,0,0,0,0
15/02/2023 17:21,202212,MIDDLE EAST,SAUDI ARABIA,HEATHROW,RIYADH,39373,39373,0,27158,27158,0,44.977539
15/02/2023 17:21,202212,MIDDLE EAST,SAUDI ARABIA,MANCHESTER,JEDDAH,10261,10261,0,2409,2409,0,325.944375
15/02/2023 17:21,202212,MIDDLE EAST,SAUDI ARABIA,NEWCASTLE,RIYADH,200,0,200,0,0,0,0
15/02/2023 17:21,202212,MIDDLE EAST,UNITED ARAB EMIRATES,GATWICK,DUBAI,91932,91932,0,15090,15090,0,509.224652
15/02/2023 17:21,202212,MIDDLE EAST,UNITED ARAB EMIRATES,HEATHROW,ABU DHABI INTERNATIONAL,70762,70762,0,44892,44892,0,57.627194
15/02/2023 17:21,202212,MIDDLE EAST,UNITED ARAB EMIRATES,HEATHROW,DUBAI,221489,221489,0,203393,203393,0,8.897061
15/02/2023 17:21,202212,MIDDLE EAST,UNITED ARAB EMIRATES,STANSTED,DUBAI,19173,19173,0,0,0,0,0
15/02/2023 17:21,202212,MIDDLE EAST,UNITED ARAB EMIRATES,BIGGIN HILL,DUBAI (WORLD CENTRAL),6,0,6,0,0,0,0
15/02/2023 17:21,202212,MIDDLE EAST,UNITED ARAB EMIRATES,BIRMINGHAM,DUBAI,47979,47979,0,28425,28425,0,68.791557
15/02/2023 17:21,202212,MIDDLE EAST,UNITED ARAB EMIRATES,GLASGOW,DUBAI,20601,20601,0,17675,17675,0,16.554455
15/02/2023 17:21,202212,MIDDLE EAST,UNITED ARAB EMIRATES,MANCHESTER,ABU DHABI INTERNATIONAL,20165,20165,0,15142,15142,0,33.172632
15/02/2023 17:21,202212,MIDDLE EAST,UNITED ARAB EMIRATES,MANCHESTER,DUBAI,92458,92458,0,52970,52970,0,74.547857
15/02/2023 17:21,202212,MIDDLE EAST,UNITED ARAB EMIRATES,NEWCASTLE,DUBAI,18625,18625,0,8387,8387,0,122.06987
15/02/2023 17:21,202212,INDIAN SUB-CONTINENT,BANGLADESH,HEATHROW,DHAKHA,9847,9847,0,2291,2291,0,329.812309
15/02/2023 17:21,202212,INDIAN SUB-CONTINENT,BANGLADESH,HEATHROW,SYLHET,4711,4711,0,7829,7829,0,-39.826287
15/02/2023 17:21,202212,INDIAN SUB-CONTINENT,BANGLADESH,MANCHESTER,DHAKHA,6095,6095,0,773,773,0,688.486417
15/02/2023 17:21,202212,INDIAN SUB-CONTINENT,INDIA,GATWICK,GOA,2098,0,2098,0,0,0,0
15/02/2023 17:21,202212,INDIAN SUB-CONTINENT,INDIA,GATWICK,MUMBAI,14,14,0,0,0,0,0
15/02/2023 17:21,202212,INDIAN SUB-CONTINENT,INDIA,HEATHROW,AHMEDABAD,8664,8664,0,3814,3814,0,127.163083
15/02/2023 17:21,202212,INDIAN SUB-CONTINENT,INDIA,HEATHROW,AMRITSAR,5011,5011,0,1725,1725,0,190.492754
15/02/2023 17:21,202212,INDIAN SUB-CONTINENT,INDIA,HEATHROW,BANGALORE (BENGALURU),11865,11865,0,13853,13853,0,-14.350682
15/02/2023 17:21,202212,INDIAN SUB-CONTINENT,INDIA,HEATHROW,CHENNAI,11483,11483,0,6820,6820,0,68.372434
15/02/2023 17:21,202212,INDIAN SUB-CONTINENT,INDIA,HEATHROW,COCHIN,6126,6126,0,5750,5750,0,6.53913
15/02/2023 17:21,202212,INDIAN SUB-CONTINENT,INDIA,HEATHROW,DELHI,109273,109273,0,49164,49164,0,122.262224
15/02/2023 17:21,202212,INDIAN SUB-CONTINENT,INDIA,HEATHROW,GOA,6289,6289,0,4165,4165,0,50.996399
15/02/2023 17:21,202212,INDIAN SUB-CONTINENT,INDIA,HEATHROW,HYDERABAD ( RAJIV GHANDI ),16532,16532,0,9134,9134,0,80.994088
15/02/2023 17:21,202212,INDIAN SUB-CONTINENT,INDIA,HEATHROW,KOLKATA,0,0,0,1770,1770,0,-100
15/02/2023 17:21,202212,INDIAN SUB-CONTINENT,INDIA,HEATHROW,MUMBAI,85014,85014,0,33541,33541,0,153.462926
15/02/2023 17:21,202212,INDIAN SUB-CONTINENT,INDIA,BIRMINGHAM,AMRITSAR,5912,5912,0,2130,2130,0,177.558685
15/02/2023 17:21,202212,INDIAN SUB-CONTINENT,INDIA,BIRMINGHAM,DELHI,6198,6198,0,0,0,0,0
15/02/2023 17:21,202212,INDIAN SUB-CONTINENT,INDIA,MANCHESTER,GOA,1874,0,1874,0,0,0,0
15/02/2023 17:21,202212,INDIAN SUB-CONTINENT,PAKISTAN,HEATHROW,ISLAMABAD INTERNATIONAL AIRPORT,11853,11853,0,16426,13084,3342,-27.84001
15/02/2023 17:21,202212,INDIAN SUB-CONTINENT,PAKISTAN,HEATHROW,LAHORE,8500,8500,0,11850,11850,0,-28.270042
15/02/2023 17:21,202212,INDIAN SUB-CONTINENT,PAKISTAN,BIRMINGHAM,ISLAMABAD INTERNATIONAL AIRPORT,0,0,0,1660,0,1660,-100
15/02/2023 17:21,202212,INDIAN SUB-CONTINENT,PAKISTAN,MANCHESTER,ISLAMABAD INTERNATIONAL AIRPORT,0,0,0,9792,7033,2759,-100
15/02/2023 17:21,202212,INDIAN SUB-CONTINENT,SRI LANKA,HEATHROW,COLOMBO,21911,21911,0,13591,13591,0,61.216982
15/02/2023 17:21,202212,FAR EAST,BRUNEI,HEATHROW,BANDAR SERI BEGAWAN,5899,5899,0,379,379,0,1456.46438
15/02/2023 17:21,202212,FAR EAST,CHINA,HEATHROW,BEIJING,1623,1623,0,0,0,0,0
15/02/2023 17:21,202212,FAR EAST,CHINA,HEATHROW,GUANGZHOU BAIYUN INTERNATIONAL,1585,1585,0,0,0,0,0
15/02/2023 17:21,202212,FAR EAST,CHINA,HEATHROW,QINGDAO,1436,1436,0,0,0,0,0
15/02/2023 17:21,202212,FAR EAST,CHINA,HEATHROW,SHANGHAI (PU DONG),4294,4294,0,0,0,0,0
15/02/2023 17:21,202212,FAR EAST,CHINA,MANCHESTER,BEIJING,816,816,0,0,0,0,0
15/02/2023 17:21,202212,FAR EAST,HONG KONG,HEATHROW,HONG KONG (CHEK LAP KOK),49968,49968,0,17306,17306,0,188.732232
15/02/2023 17:21,202212,FAR EAST,HONG KONG,MANCHESTER,HONG KONG (CHEK LAP KOK),10523,10523,0,2551,2551,0,312.5049
15/02/2023 17:21,202212,FAR EAST,JAPAN,HEATHROW,OSAKA (KANSAI),0,0,0,339,339,0,-100
15/02/2023 17:21,202212,FAR EAST,JAPAN,HEATHROW,TOKYO (HANEDA),36485,36485,0,7379,7379,0,394.443692
15/02/2023 17:21,202212,FAR EAST,MALAYSIA,HEATHROW,KUALA LUMPUR (SEPANG),30675,30675,0,4688,4688,0,554.330205
15/02/2023 17:21,202212,FAR EAST,PHILIPPINES,HEATHROW,MANILA,0,0,0,663,663,0,-100
15/02/2023 17:21,202212,FAR EAST,REPUBLIC OF KOREA,HEATHROW,SEOUL (INCHEON),23117,23117,0,2943,2943,0,685.490996
15/02/2023 17:21,202212,FAR EAST,SINGAPORE,GATWICK,SINGAPORE,0,0,0,1903,1903,0,-100
15/02/2023 17:21,202212,FAR EAST,SINGAPORE,HEATHROW,SINGAPORE,115206,115206,0,47270,47270,0,143.719061
15/02/2023 17:21,202212,FAR EAST,SINGAPORE,MANCHESTER,SINGAPORE,6745,6745,0,3206,3206,0,110.386775
15/02/2023 17:21,202212,FAR EAST,TAIWAN,HEATHROW,TAIPEI,7549,7549,0,193,193,0,3811.398964
15/02/2023 17:21,202212,FAR EAST,THAILAND,GATWICK,PHUKET,2679,0,2679,468,0,468,472.435897
15/02/2023 17:21,202212,FAR EAST,THAILAND,HEATHROW,BANGKOK SUVARNABHUMI ,56610,56610,0,11480,11480,0,393.118467
15/02/2023 17:21,202212,FAR EAST,THAILAND,MANCHESTER,PHUKET,2872,0,2872,0,0,0,0
15/02/2023 17:21,202212,FAR EAST,VIETNAM,GATWICK,HANOI,2057,2057,0,0,0,0,0
15/02/2023 17:21,202212,FAR EAST,VIETNAM,GATWICK,HO CHI MINH CITY,1984,1984,0,0,0,0,0
15/02/2023 17:21,202212,FAR EAST,VIETNAM,HEATHROW,HANOI,7813,7813,0,129,129,0,5956.589147
15/02/2023 17:21,202212,FAR EAST,VIETNAM,HEATHROW,HO CHI MINH CITY,6043,6043,0,0,0,0,0
15/02/2023 17:21,202212,AUSTRALASIA,AUSTRALIA,HEATHROW,DARWIN,0,0,0,4164,4164,0,-100
15/02/2023 17:21,202212,AUSTRALASIA,AUSTRALIA,HEATHROW,MELBOURNE,4225,4225,0,3761,3761,0,12.337144
15/02/2023 17:21,202212,AUSTRALASIA,AUSTRALIA,HEATHROW,PERTH (AUSTRALIA),12009,12009,0,0,0,0,0
15/02/2023 17:21,202212,AUSTRALASIA,AUSTRALIA,HEATHROW,SYDNEY,20886,20886,0,8586,8586,0,143.256464
15/02/2023 17:21,202212,CANADA,CANADA,GATWICK,CALGARY,0,0,0,5531,5531,0,-100
15/02/2023 17:21,202212,CANADA,CANADA,GATWICK,MONTREAL (DORVAL),4526,4452,74,0,0,0,0
15/02/2023 17:21,202212,CANADA,CANADA,GATWICK,TORONTO,11250,11250,0,8009,8009,0,40.466975
15/02/2023 17:21,202212,CANADA,CANADA,HEATHROW,CALGARY,32357,32357,0,5194,5194,0,522.96881
15/02/2023 17:21,202212,CANADA,CANADA,HEATHROW,HALIFAX INT,7951,7951,0,0,0,0,0
15/02/2023 17:21,202212,CANADA,CANADA,HEATHROW,MONTREAL (DORVAL),27752,27752,0,13063,13063,0,112.44737
15/02/2023 17:21,202212,CANADA,CANADA,HEATHROW,TORONTO,81415,81415,0,49346,49346,0,64.988044
15/02/2023 17:21,202212,CANADA,CANADA,HEATHROW,VANCOUVER,29520,29520,0,27875,27875,0,5.901345
15/02/2023 17:21,202212,CANADA,CANADA,GLASGOW,TORONTO,2637,2637,0,998,998,0,164.228457
15/02/2023 17:21,202212,CANADA,CANADA,MANCHESTER,TORONTO,3368,3368,0,2011,2011,0,67.478866
15/02/2023 17:21,202212,UNITED STATES OF AMERICA,USA,GATWICK,BOSTON,5835,5835,0,0,0,0,0
15/02/2023 17:21,202212,UNITED STATES OF AMERICA,USA,GATWICK,MIAMI INTERNATIONAL,169,169,0,0,0,0,0
15/02/2023 17:21,202212,UNITED STATES OF AMERICA,USA,GATWICK,NEW YORK (JF KENNEDY),44325,44325,0,5221,5221,0,748.975292
15/02/2023 17:21,202212,UNITED STATES OF AMERICA,USA,GATWICK,ORLANDO,24204,23732,472,6113,6113,0,295.943072
15/02/2023 17:21,202212,UNITED STATES OF AMERICA,USA,GATWICK,TAMPA,10814,10814,0,12009,12009,0,-9.95087
15/02/2023 17:21,202212,UNITED STATES OF AMERICA,USA,HEATHROW,ATLANTA,49677,49677,0,32000,32000,0,55.240625
15/02/2023 17:21,202212,UNITED STATES OF AMERICA,USA,HEATHROW,AUSTIN (BERGSTROM),18105,18105,0,5575,5575,0,224.753363
15/02/2023 17:21,202212,UNITED STATES OF AMERICA,USA,HEATHROW,BALTIMORE,7291,7291,0,4523,4523,0,61.19832
15/02/2023 17:21,202212,UNITED STATES OF AMERICA,USA,HEATHROW,BOSTON,71763,71763,0,37669,37669,0,90.509437
15/02/2023 17:21,202212,UNITED STATES OF AMERICA,USA,HEATHROW,CHARLOTTE,29323,29323,0,13374,13374,0,119.253776
15/02/2023 17:21,202212,UNITED STATES OF AMERICA,USA,HEATHROW,CHICAGO (O'HARE),74287,74287,0,41476,41476,0,79.1084
15/02/2023 17:21,202212,UNITED STATES OF AMERICA,USA,HEATHROW,DALLAS/FORT WORTH,62194,62194,0,39564,39564,0,57.198463
15/02/2023 17:21,202212,UNITED STATES OF AMERICA,USA,HEATHROW,DENVER INTERNATIONAL,24910,24910,0,7253,7253,0,243.444092
15/02/2023 17:21,202212,UNITED STATES OF AMERICA,USA,HEATHROW,DETROIT,10671,10671,0,6178,6178,0,72.725801
15/02/2023 17:21,202212,UNITED STATES OF AMERICA,USA,HEATHROW,HOUSTON,42038,42038,0,19641,19641,0,114.031872
15/02/2023 17:21,202212,UNITED STATES OF AMERICA,USA,HEATHROW,LAS VEGAS,27431,27431,0,15084,15084,0,81.854946
15/02/2023 17:21,202212,UNITED STATES OF AMERICA,USA,HEATHROW,LOS ANGELES INTERNATIONAL,108690,108690,0,62466,62466,0,73.998655
15/02/2023 17:21,202212,UNITED STATES OF AMERICA,USA,HEATHROW,MIAMI INTERNATIONAL,91882,91882,0,59961,59961,0,53.23627
15/02/2023 17:21,202212,UNITED STATES OF AMERICA,USA,HEATHROW,MINNEAPOLIS-ST PAUL,11681,11681,0,0,0,0,0
15/02/2023 17:21,202212,UNITED STATES OF AMERICA,USA,HEATHROW,NASHVILLE METROPOLITAN,8839,8839,0,2740,2740,0,222.591241
15/02/2023 17:21,202212,UNITED STATES OF AMERICA,USA,HEATHROW,NEW ORLEANS,4896,4896,0,2206,2206,0,121.940163
15/02/2023 17:21,202212,UNITED STATES OF AMERICA,USA,HEATHROW,NEW YORK (JF KENNEDY),243145,243145,0,155858,155858,0,56.004183
15/02/2023 17:21,202212,UNITED STATES OF AMERICA,USA,HEATHROW,NEW YORK (NEWARK),89290,89290,0,40650,40650,0,119.655597
15/02/2023 17:21,202212,UNITED STATES OF AMERICA,USA,HEATHROW,ORLANDO,18264,17416,848,28168,28168,0,-35.160466
15/02/2023 17:21,202212,UNITED STATES OF AMERICA,USA,HEATHROW,PHILADELPHIA INTERNATIONAL,29357,29357,0,18816,18816,0,56.021471
15/02/2023 17:21,202212,UNITED STATES OF AMERICA,USA,HEATHROW,PHOENIX,29577,29577,0,11814,11814,0,150.35551
15/02/2023 17:21,202212,UNITED STATES OF AMERICA,USA,HEATHROW,PITTSBURGH,5129,5129,0,0,0,0,0
15/02/2023 17:21,202212,UNITED STATES OF AMERICA,USA,HEATHROW,PORTLAND (OREGON),6258,6258,0,0,0,0,0
15/02/2023 17:21,202212,UNITED STATES OF AMERICA,USA,HEATHROW,RALEIGH,7921,7921,0,0,0,0,0
15/02/2023 17:21,202212,UNITED STATES OF AMERICA,USA,HEATHROW,SALT LAKE CITY,7775,7775,0,0,0,0,0
15/02/2023 17:21,202212,UNITED STATES OF AMERICA,USA,HEATHROW,SAN DIEGO,15621,15621,0,7954,7954,0,96.391753
15/02/2023 17:21,202212,UNITED STATES OF AMERICA,USA,HEATHROW,SAN FRANCISCO,73309,73309,0,38963,38963,0,88.150296
15/02/2023 17:21,202212,UNITED STATES OF AMERICA,USA,HEATHROW,SAN JOSE,4253,4253,0,0,0,0,0
15/02/2023 17:21,202212,UNITED STATES OF AMERICA,USA,HEATHROW,SEATTLE (TACOMA),34931,34931,0,18347,18347,0,90.3908
15/02/2023 17:21,202212,UNITED STATES OF AMERICA,USA,HEATHROW,TAMPA,10873,10873,0,0,0,0,0
15/02/2023 17:21,202212,UNITED STATES OF AMERICA,USA,HEATHROW,WASHINGTON (DULLES),55420,55420,0,32572,32572,0,70.146138
15/02/2023 17:21,202212,UNITED STATES OF AMERICA,USA,STANSTED,CINCINNATI,335,0,335,0,0,0,0
15/02/2023 17:21,202212,UNITED STATES OF AMERICA,USA,STANSTED,ORLANDO,229,0,229,0,0,0,0
15/02/2023 17:21,202212,UNITED STATES OF AMERICA,USA,BIRMINGHAM,MELBOURNE FLATS,244,0,244,0,0,0,0
15/02/2023 17:21,202212,UNITED STATES OF AMERICA,USA,EDINBURGH,NEW YORK (JF KENNEDY),7736,7736,0,0,0,0,0
15/02/2023 17:21,202212,UNITED STATES OF AMERICA,USA,EDINBURGH,NEW YORK (NEWARK),9484,9484,0,0,0,0,0
15/02/2023 17:21,202212,UNITED STATES OF AMERICA,USA,MANCHESTER,ATLANTA,6740,6740,0,3903,3903,0,72.687676
15/02/2023 17:21,202212,UNITED STATES OF AMERICA,USA,MANCHESTER,HOUSTON,2898,2898,0,1541,1541,0,88.059701
15/02/2023 17:21,202212,UNITED STATES OF AMERICA,USA,MANCHESTER,MELBOURNE FLATS,280,0,280,0,0,0,0
15/02/2023 17:21,202212,UNITED STATES OF AMERICA,USA,MANCHESTER,NEW YORK (JF KENNEDY),21296,21296,0,17157,17157,0,24.124264
15/02/2023 17:21,202212,UNITED STATES OF AMERICA,USA,MANCHESTER,ORLANDO,20477,20477,0,14422,14422,0,41.984468
15/02/2023 17:21,202212,CENTRAL AMERICA,COSTA RICA,GATWICK,LIBERIA,2942,0,2942,2210,0,2210,33.122172
15/02/2023 17:21,202212,CENTRAL AMERICA,COSTA RICA,GATWICK,SAN JOSE COST RICA,7571,7571,0,4670,4670,0,62.119914
15/02/2023 17:21,202212,CENTRAL AMERICA,CUBA,MANCHESTER,VARADERO,4776,0,4776,1842,0,1842,159.283388
15/02/2023 17:21,202212,CENTRAL AMERICA,DOMINICAN REPUBLIC,GATWICK,PUNTA CANA,17251,8678,8573,10670,4223,6447,61.677601
15/02/2023 17:21,202212,CENTRAL AMERICA,DOMINICAN REPUBLIC,BIRMINGHAM,PUNTA CANA,296,0,296,0,0,0,0
15/02/2023 17:21,202212,CENTRAL AMERICA,DOMINICAN REPUBLIC,MANCHESTER,PUNTA CANA,8726,0,8726,5505,0,5505,58.510445
15/02/2023 17:21,202212,CENTRAL AMERICA,MEXICO,GATWICK,CANCUN,33832,33832,0,25519,25519,0,32.575728
15/02/2023 17:21,202212,CENTRAL AMERICA,MEXICO,GATWICK,PUERTO VALLARTA,2086,0,2086,2638,0,2638,-20.924943
15/02/2023 17:21,202212,CENTRAL AMERICA,MEXICO,HEATHROW,MEXICO CITY,21335,21335,0,7441,7441,0,186.722215
15/02/2023 17:21,202212,CENTRAL AMERICA,MEXICO,BIRMINGHAM,CANCUN,5421,5421,0,5474,5474,0,-0.968213
15/02/2023 17:21,202212,CENTRAL AMERICA,MEXICO,MANCHESTER,CANCUN,12488,12488,0,10272,10272,0,21.573209
15/02/2023 17:21,202212,CENTRAL AMERICA,MEXICO,MANCHESTER,PUERTO VALLARTA,2398,0,2398,3004,0,3004,-20.173103
15/02/2023 17:21,202212,SOUTH AMERICA,ARGENTINA,HEATHROW,BUENOS AIRES,7973,7973,0,6583,6583,0,21.114993
15/02/2023 17:21,202212,SOUTH AMERICA,BRAZIL,HEATHROW,RIO DE JANEIRO (GALEAO),7932,7931,1,6477,6477,0,22.464104
15/02/2023 17:21,202212,SOUTH AMERICA,BRAZIL,HEATHROW,SAO PAULO (GUARULHOS),38700,38700,0,22975,22975,0,68.443961
15/02/2023 17:21,202212,SOUTH AMERICA,CHILE,HEATHROW,SANTIAGO DE CHILE,5190,5190,0,5241,5241,0,-0.973097
15/02/2023 17:21,202212,SOUTH AMERICA,COLOMBIA,HEATHROW,BOGOTA,14603,14603,0,0,0,0,0
15/02/2023 17:21,202212,CARIBBEAN AREA,ANTIGUA AND BARBUDA,GATWICK,ANTIGUA,11586,11586,0,9459,9459,0,22.486521
15/02/2023 17:21,202212,CARIBBEAN AREA,ANTIGUA AND BARBUDA,HEATHROW,ANTIGUA,6251,6251,0,7472,7472,0,-16.341006
15/02/2023 17:21,202212,CARIBBEAN AREA,BAHAMAS,HEATHROW,NASSAU,6356,6356,0,10824,10824,0,-41.27864
15/02/2023 17:21,202212,CARIBBEAN AREA,BARBADOS,GATWICK,BRIDGETOWN,22811,10407,12404,13665,8172,5493,66.930113
15/02/2023 17:21,202212,CARIBBEAN AREA,BARBADOS,HEATHROW,BRIDGETOWN,32125,32125,0,28546,28546,0,12.537659
15/02/2023 17:21,202212,CARIBBEAN AREA,BARBADOS,BIRMINGHAM,BRIDGETOWN,8221,0,8221,2717,0,2717,202.576371
15/02/2023 17:21,202212,CARIBBEAN AREA,BARBADOS,CARDIFF WALES,BRIDGETOWN,195,0,195,0,0,0,0
15/02/2023 17:21,202212,CARIBBEAN AREA,BARBADOS,EDINBURGH,BRIDGETOWN,0,0,0,707,707,0,-100
15/02/2023 17:21,202212,CARIBBEAN AREA,BARBADOS,GLASGOW,BRIDGETOWN,1166,0,1166,614,0,614,89.90228
15/02/2023 17:21,202212,CARIBBEAN AREA,BARBADOS,MANCHESTER,BRIDGETOWN,24549,12318,12231,14155,7573,6582,73.429883
15/02/2023 17:21,202212,CARIBBEAN AREA,BARBADOS,NEWCASTLE,BRIDGETOWN,295,295,0,0,0,0,0
15/02/2023 17:21,202212,CARIBBEAN AREA,BERMUDA,HEATHROW,BERMUDA,8111,8111,0,6245,6245,0,29.879904
15/02/2023 17:21,202212,CARIBBEAN AREA,CAYMAN ISLANDS,HEATHROW,GRAND CAYMAN,4290,4290,0,0,0,0,0
15/02/2023 17:21,202212,CARIBBEAN AREA,GRENADA,GATWICK,GRENADA,3112,3112,0,2053,2053,0,51.583049
15/02/2023 17:21,202212,CARIBBEAN AREA,GRENADA,HEATHROW,GRENADA,1539,1539,0,754,754,0,104.111406
15/02/2023 17:21,202212,CARIBBEAN AREA,JAMAICA,GATWICK,KINGSTON,7790,7790,0,6229,6229,0,25.060202
15/02/2023 17:21,202212,CARIBBEAN AREA,JAMAICA,GATWICK,MONTEGO BAY,9034,0,9034,10962,4453,6509,-17.588031
15/02/2023 17:21,202212,CARIBBEAN AREA,JAMAICA,HEATHROW,MONTEGO BAY,10134,10134,0,5902,5902,0,71.704507
15/02/2023 17:21,202212,CARIBBEAN AREA,JAMAICA,BIRMINGHAM,MONTEGO BAY,6071,0,6071,2748,0,2748,120.924309
15/02/2023 17:21,202212,CARIBBEAN AREA,JAMAICA,BRISTOL,MONTEGO BAY,301,0,301,0,0,0,0
15/02/2023 17:21,202212,CARIBBEAN AREA,JAMAICA,GLASGOW,MONTEGO BAY,594,0,594,0,0,0,0
15/02/2023 17:21,202212,CARIBBEAN AREA,JAMAICA,MANCHESTER,MONTEGO BAY,8306,0,8306,5130,0,5130,61.910331
15/02/2023 17:21,202212,CARIBBEAN AREA,SAINT KITTS AND NEVIS,GATWICK,ST KITTS,1463,1463,0,829,829,0,76.477684
15/02/2023 17:21,202212,CARIBBEAN AREA,SAINT VINCENT AND THE GRENADINES,HEATHROW,E T JOSHUA,2673,2673,0,781,781,0,242.253521
15/02/2023 17:21,202212,CARIBBEAN AREA,ST LUCIA,GATWICK,ST LUCIA (HEWANORRA),12191,9857,2334,10389,7695,2694,17.345269
15/02/2023 17:21,202212,CARIBBEAN AREA,ST LUCIA,HEATHROW,ST LUCIA (HEWANORRA),4492,4492,0,6797,6797,0,-33.91202
15/02/2023 17:21,202212,CARIBBEAN AREA,TRINIDAD AND TOBAGO,GATWICK,PORT OF SPAIN,5469,5469,0,3148,3148,0,73.729352
15/02/2023 17:21,202212,CARIBBEAN AREA,TRINIDAD AND TOBAGO,GATWICK,TOBAGO,1121,1121,0,0,0,0,0
15/02/2023 17:21,202212,CARIBBEAN AREA,TRINIDAD AND TOBAGO,HEATHROW,TOBAGO,372,372,0,0,0,0,0
15/02/2023 17:21,202212,CARIBBEAN AREA,TURKS AND CAICOS ISLANDS,HEATHROW,PROVIDENCIALES,862,862,0,0,0,0,0
15/02/2023 17:21,202212,INDIAN OCEAN ISLANDS,MALDIVE ISLANDS,HEATHROW,MALE INTERNATIONAL,13597,13597,0,14531,14531,0,-6.427637
15/02/2023 17:21,202212,INDIAN OCEAN ISLANDS,MAURITIUS,GATWICK,MAURITIUS,8634,8634,0,6582,6582,0,31.175934
15/02/2023 17:21,202212,INDIAN OCEAN ISLANDS,MAURITIUS,HEATHROW,MAURITIUS,13157,13157,0,10663,10663,0,23.38929
15/02/2023 17:21,202212,ATLANTIC OCEAN ISLANDS,ASCENSION ISLAND,STANSTED,SAINT HELENA,0,0,0,169,0,169,-100
15/02/2023 17:21,202212,ATLANTIC OCEAN ISLANDS,CAPE VERDE ISLANDS,GATWICK,BOA VISTA (RABIL),6371,6371,0,3182,3182,0,100.219987
15/02/2023 17:21,202212,ATLANTIC OCEAN ISLANDS,CAPE VERDE ISLANDS,GATWICK,ILHA DO SAL C.VERDE,6871,6759,112,4847,4847,0,41.757788
15/02/2023 17:21,202212,ATLANTIC OCEAN ISLANDS,CAPE VERDE ISLANDS,BIRMINGHAM,BOA VISTA (RABIL),3157,3157,0,1800,1800,0,75.388889
15/02/2023 17:21,202212,ATLANTIC OCEAN ISLANDS,CAPE VERDE ISLANDS,BIRMINGHAM,ILHA DO SAL C.VERDE,3855,3855,0,1333,1333,0,189.197299
15/02/2023 17:21,202212,ATLANTIC OCEAN ISLANDS,CAPE VERDE ISLANDS,BRISTOL,ILHA DO SAL C.VERDE,1388,1388,0,566,566,0,145.229682
15/02/2023 17:21,202212,ATLANTIC OCEAN ISLANDS,CAPE VERDE ISLANDS,MANCHESTER,BOA VISTA (RABIL),5456,5456,0,3554,3554,0,53.517164
15/02/2023 17:21,202212,ATLANTIC OCEAN ISLANDS,CAPE VERDE ISLANDS,MANCHESTER,ILHA DO SAL C.VERDE,6241,6241,0,4399,4399,0,41.873153
15/02/2023 17:21,202212,OIL RIGS,OIL RIGS,ABERDEEN,OIL RIGS,27280,0,27280,23526,0,23526,15.956814
15/02/2023 17:21,202212,OIL RIGS,OIL RIGS,BLACKPOOL,OIL RIGS,1132,0,1132,0,0,0,0
15/02/2023 17:21,202212,OIL RIGS,OIL RIGS,HUMBERSIDE,OIL RIGS,689,0,689,1448,0,1448,-52.417127
15/02/2023 17:21,202212,OIL RIGS,OIL RIGS,NORWICH,OIL RIGS,6454,0,6454,5911,0,5911,9.186263
15/02/2023 17:21,202212,OIL RIGS,OIL RIGS,SUMBURGH,OIL RIGS,5069,0,5069,6365,0,6365,-20.361351
